Fragment_length	Missing_sites	CCGG-CCGG	CCGG-GCGC	GCGC-GCGC	Sum
1	0	0	18854	0	18854
2	0	0	37368	0	37368
3	0	0	4847	0	4847
4	0	10778	5697	11178	27653
5	0	8616	25140	7691	41447
6	0	10138	44137	7256	61531
7	0	7941	10024	5464	23429
8	0	6458	14024	6724	27206
9	0	6644	10237	5113	21994
10	0	5810	16877	4094	26781
11	0	5199	11548	4544	21291
12	0	6062	14769	10739	31570
13	0	6144	11033	4023	21200
14	0	5116	36178	4185	45479
15	0	5421	9576	3991	18988
16	0	6501	11174	4307	21982
17	0	12901	9789	3666	26356
18	0	6185	29680	4785	40650
19	0	5897	9012	3713	18622
20	0	4955	8118	4070	17143
21	0	5039	7928	3601	16568
22	0	4757	8920	3437	17114
23	0	5120	8615	3070	16805
24	0	6476	6452	3240	16168
25	0	4525	7488	3234	15247
26	0	4239	7010	2844	14093
27	0	4527	7037	5421	16985
28	0	6130	6607	3045	15782
29	0	4799	7902	2662	15363
30	0	4934	27196	2765	34895
31	0	7931	6861	2632	17424
32	0	8649	6322	2655	17626
33	0	5183	7854	2436	15473
34	0	4385	26688	2310	33383
35	0	4153	5896	2336	12385
36	0	4717	5502	2336	12555
37	0	8892	5594	3069	17555
38	0	3983	5692	2081	11756
39	0	3883	5070	2301	11254
40	0	8199	4843	2326	15368
41	0	4190	4544	3408	12142
42	0	3588	5357	2102	11047
43	0	3164	4942	1768	9874
44	0	4039	4823	2160	11022
45	0	4540	4677	1893	11110
46	0	3591	4167	1898	9656
47	0	3303	4437	1815	9555
48	0	4069	4806	1902	10777
49	0	8603	5454	1795	15852
50	0	6346	25133	1886	33365
51	0	3610	5280	1560	10450
52	0	3618	5194	1609	10421
53	0	3363	5680	1341	10384
54	0	3599	30093	1405	35097
55	0	3375	4892	1267	9534
56	0	3013	4497	1398	8908
57	0	2990	3954	1294	8238
58	0	2756	8163	1360	12279
59	0	3611	3744	1434	8789
60	0	2821	3795	1315	7931
61	0	2809	4184	1376	8369
62	0	2529	4760	1269	8558
63	0	2554	3798	1188	7540
64	0	2540	3888	1187	7615
65	0	2958	4005	1098	8061
66	0	4317	4295	1208	9820
67	0	5506	3577	1051	10134
68	0	25118	3400	1261	29779
69	0	3925	2768	1108	7801
70	0	2560	3037	1007	6604
71	0	2297	3038	983	6318
72	0	2372	2749	1071	6192
73	0	2266	2791	1064	6121
74	0	2291	3089	1017	6397
75	0	2328	2706	1087	6121
76	0	2331	2980	999	6310
77	0	2794	2559	1056	6409
78	0	2229	3002	1075	6306
79	0	2298	4370	1123	7791
80	0	2523	2982	973	6478
81	0	2187	2944	1067	6198
82	0	2459	2652	1024	6135
83	0	2075	4170	1918	8163
84	0	2439	2496	15463	20398
85	0	2858	2937	1816	7611
86	0	2414	2414	1900	6728
87	0	2498	2340	1383	6221
88	0	1822	2390	5780	9992
89	0	1980	2386	1778	6144
90	0	2296	2268	992	5556
91	0	2027	2204	925	5156
92	0	2158	2362	1304	5824
93	0	1804	2436	795	5035
94	0	1902	2387	945	5234
95	0	1770	2479	850	5099
96	0	1988	2363	1606	5957
97	0	2144	3011	827	5982
98	0	1872	7253	915	10040
99	0	1897	3317	898	6112
100	0	1781	2710	766	5257
101	0	1734	2975	669	5378
102	0	1725	7396	738	9859
103	0	1820	3022	686	5528
104	1	1942	2787	750	5480
105	0	1995	2319	639	4953
106	0	2124	2490	677	5291
107	0	2010	2169	687	4866
108	0	1914	2340	697	4951
109	0	1674	2023	614	4311
110	0	1609	2213	627	4449
111	0	1699	1915	616	4230
112	0	1640	2022	637	4299
113	0	1859	1850	650	4359
114	0	1648	1883	748	4279
115	0	1766	1875	697	4338
116	1	2805	2144	861	5811
117	0	2386	1956	621	4963
118	0	2136	2047	687	4870
119	0	1610	2086	724	4420
120	0	1680	2365	888	4933
121	0	1732	2313	1972	6017
122	0	1784	2151	748	4683
123	0	1578	2124	623	4325
124	0	1578	2178	607	4363
125	0	1492	2237	624	4353
126	0	1747	2295	603	4645
127	0	1648	4095	568	6311
128	0	1687	9529	567	11783
129	0	1693	6586	720	8999
130	0	1662	4010	860	6532
131	0	1812	4972	848	7632
132	0	2172	10139	765	13076
133	0	4890	6657	998	12545
134	0	10225	3987	1417	15629
135	0	8980	2957	1179	13116
136	0	4314	2634	876	7824
137	0	3069	2243	846	6158
138	0	2512	2164	734	5410
139	0	2123	2125	1062	5310
140	0	1824	2029	967	4820
141	0	1733	2118	2052	5903
142	0	1652	2188	2325	6165
143	0	2492	2555	2586	7633
144	0	1566	2727	1729	6022
145	0	1493	2899	3604	7996
146	0	1372	2632	6279	10283
147	0	1464	3826	5089	10379
148	0	1438	4828	2742	9008
149	0	1436	4672	1493	7601
150	0	1441	3144	1159	5744
151	0	1395	3515	814	5724
152	0	1431	3998	802	6231
153	0	1472	3815	766	6053
154	0	1418	2551	655	4624
155	0	1345	2211	640	4196
156	0	1302	1965	651	3918
157	0	1326	1906	738	3970
158	0	1386	1729	589	3704
159	0	1314	1690	534	3538
160	0	1321	1771	560	3652
161	0	1264	1615	565	3444
162	0	1344	1635	516	3495
163	0	1340	1551	515	3406
164	0	1287	1738	545	3570
165	0	1339	1637	498	3474
166	0	1252	1569	516	3337
167	0	1294	1575	497	3366
168	0	1347	1616	527	3490
169	0	1324	1661	528	3513
170	0	1425	1632	574	3631
171	0	1501	1505	838	3844
172	0	1419	1491	513	3423
173	0	1291	1522	468	3281
174	0	1296	1500	475	3271
175	0	1451	1451	428	3330
176	0	1347	1514	461	3322
177	0	1260	1311	412	2983
178	0	1258	1444	441	3143
179	0	1140	1474	385	2999
180	0	1198	1500	480	3178
181	0	1223	1409	458	3090
182	0	1272	1410	461	3143
183	0	1270	1438	446	3154
184	0	1234	1520	509	3263
185	0	1214	1414	430	3058
186	0	1188	1467	453	3108
187	0	1279	1623	458	3360
188	0	1152	1438	465	3055
189	0	1226	1435	426	3087
190	0	1235	1470	436	3141
191	0	1227	1559	423	3209
192	0	1304	1467	441	3212
193	0	1217	1583	425	3225
194	0	1171	1629	420	3220
195	0	1147	2667	426	4240
196	0	1232	3252	404	4888
197	0	1271	3182	361	4814
198	0	1305	2461	424	4190
199	0	1436	2775	431	4642
200	0	1773	3474	395	5642
201	0	3351	3206	388	6945
202	0	4547	2012	411	6970
203	0	4573	1706	449	6728
204	0	2443	1571	458	4472
205	0	1808	1463	460	3731
206	0	1612	1435	419	3466
207	0	1467	1382	432	3281
208	0	1259	1367	410	3036
209	0	1217	1385	393	2995
210	0	1183	1307	452	2942
211	0	1158	1285	370	2813
212	0	1080	1275	413	2768
213	0	1119	1217	430	2766
214	0	1123	1212	451	2786
215	0	1013	1313	418	2744
216	0	1077	1297	421	2795
217	0	999	1234	436	2669
218	0	1014	1283	444	2741
219	0	1041	1252	486	2779
220	0	1081	1279	454	2814
221	0	1030	1239	485	2754
222	0	1007	1254	440	2701
223	0	943	1288	484	2715
224	0	1000	1245	444	2689
225	0	945	1222	462	2629
226	0	1034	1203	455	2692
227	0	1002	1268	547	2817
228	0	1017	1241	731	2989
229	0	1002	1287	1419	3708
230	0	995	1322	2040	4357
231	0	1093	1669	1857	4619
232	0	1073	1907	970	3950
233	0	1037	2109	752	3898
234	0	991	1663	596	3250
235	0	942	1812	516	3270
236	0	1001	2012	493	3506
237	0	986	1952	603	3541
238	0	1009	1563	498	3070
239	0	981	1400	486	2867
240	0	1017	1337	459	2813
241	0	1034	1297	414	2745
242	0	1005	1342	390	2737
243	0	965	1268	420	2653
244	0	962	1260	350	2572
245	0	924	1256	331	2511
246	0	970	1297	345	2612
247	0	967	1286	321	2574
248	0	1049	1231	348	2628
249	0	982	1163	308	2453
250	0	1023	1143	363	2529
251	0	967	1170	332	2469
252	0	1034	1149	331	2514
253	0	1028	1144	356	2528
254	0	933	1090	389	2412
255	0	1003	1121	347	2471
256	0	910	1087	344	2341
257	0	955	1081	316	2352
258	0	967	1025	367	2359
259	0	999	1071	406	2476
260	0	909	1051	382	2342
261	0	872	1185	340	2397
262	0	894	1147	333	2374
263	0	953	1099	318	2370
264	0	919	1124	300	2343
265	0	870	1181	309	2360
266	0	866	1106	338	2310
267	0	916	1093	303	2312
268	0	885	1081	322	2288
269	0	841	1062	303	2206
270	0	917	1029	326	2272
271	0	872	1000	310	2182
272	0	884	1033	304	2221
273	0	841	1039	319	2199
274	0	860	999	281	2140
275	0	819	1090	311	2220
276	0	818	1037	289	2144
277	0	861	1028	293	2182
278	0	918	1035	312	2265
279	0	943	1036	328	2307
280	0	839	1012	320	2171
281	0	960	1045	321	2326
282	0	903	1003	306	2212
283	0	797	1054	344	2195
284	0	799	1045	344	2188
285	0	874	1011	329	2214
286	0	853	998	309	2160
287	0	842	987	378	2207
288	0	872	1019	369	2260
289	0	990	1057	321	2368
290	0	847	1007	293	2147
291	0	834	967	335	2136
292	0	818	1000	321	2139
293	0	832	983	324	2139
294	0	826	1045	325	2196
295	0	815	999	346	2160
296	0	864	973	279	2116
297	0	803	936	312	2051
298	0	860	1031	299	2190
299	0	788	1016	348	2152
300	0	896	1052	332	2280
301	0	916	1003	325	2244
302	0	802	943	299	2044
303	0	845	1068	301	2214
304	0	860	1005	312	2177
305	0	795	999	311	2105
306	0	890	957	327	2174
307	0	891	1000	347	2238
308	0	876	1152	337	2365
309	0	813	1006	330	2149
310	0	791	1015	325	2131
311	0	857	1015	313	2185
312	0	842	1078	295	2215
313	0	773	982	305	2060
314	0	795	1006	321	2122
315	0	888	981	326	2195
316	0	793	1006	319	2118
317	0	731	972	317	2020
318	0	800	967	335	2102
319	0	758	1000	304	2062
320	0	800	1048	252	2100
321	0	792	983	304	2079
322	0	735	981	264	1980
323	0	806	956	341	2103
324	0	842	1046	275	2163
325	0	766	935	306	2007
326	0	755	970	282	2007
327	0	779	899	305	1983
328	0	758	1007	279	2044
329	0	768	920	325	2013
330	0	795	965	256	2016
331	0	781	952	258	1991
332	0	746	1054	271	2071
333	0	818	977	282	2077
334	0	744	913	310	1967
335	0	748	950	287	1985
336	0	771	945	283	1999
337	0	743	919	357	2019
338	0	726	919	323	1968
339	0	766	936	293	1995
340	0	722	862	327	1911
341	0	787	850	409	2046
342	0	747	860	462	2069
343	0	777	983	285	2045
344	0	788	893	294	1975
345	0	729	912	281	1922
346	0	681	864	258	1803
347	0	680	877	282	1839
348	0	713	911	299	1923
349	0	726	908	264	1898
350	0	721	869	277	1867
351	0	707	842	275	1824
352	0	706	869	274	1849
353	0	645	913	260	1818
354	0	716	911	273	1900
355	0	713	810	293	1816
356	0	699	906	239	1844
357	0	729	849	307	1885
358	0	720	873	273	1866
359	0	723	839	247	1809
360	0	686	870	264	1820
361	0	659	847	282	1788
362	0	711	859	281	1851
363	0	677	882	271	1830
364	0	694	813	262	1769
365	0	704	858	251	1813
366	0	688	869	268	1825
367	0	729	848	241	1818
368	0	680	866	301	1847
369	0	683	845	259	1787
370	0	732	819	262	1813
371	0	715	811	260	1786
372	0	748	805	259	1812
373	0	705	873	261	1839
374	0	692	805	241	1738
375	0	710	832	255	1797
376	0	698	848	272	1818
377	0	724	825	258	1807
378	0	686	825	271	1782
379	0	683	830	239	1752
380	0	697	762	243	1702
381	0	683	828	225	1736
382	0	684	775	244	1703
383	0	694	845	240	1779
384	0	660	770	264	1694
385	0	671	834	236	1741
386	0	687	773	244	1704
387	0	725	786	223	1734
388	0	700	778	253	1731
389	0	700	857	265	1822
390	0	680	854	257	1791
391	0	627	777	254	1658
392	0	646	822	251	1719
393	0	638	792	244	1674
394	0	683	791	262	1736
395	0	661	794	264	1719
396	0	643	818	256	1717
397	0	683	822	277	1782
398	0	639	801	263	1703
399	0	662	780	228	1670
400	0	658	851	251	1760
401	0	640	732	247	1619
402	0	630	780	245	1655
403	0	665	787	269	1721
404	0	689	769	232	1690
405	0	668	729	238	1635
406	0	693	784	289	1766
407	0	646	769	239	1654
408	0	622	822	276	1720
409	0	643	781	242	1666
410	0	629	843	257	1729
411	0	615	765	219	1599
412	0	665	728	222	1615
413	0	621	752	254	1627
414	0	654	780	225	1659
415	0	645	742	213	1600
416	0	637	748	229	1614
417	0	633	754	266	1653
418	0	593	745	266	1604
419	0	647	777	243	1667
420	0	661	770	267	1698
421	0	652	752	230	1634
422	0	613	712	217	1542
423	0	639	761	245	1645
424	0	592	750	230	1572
425	0	620	744	235	1599
426	0	624	734	235	1593
427	0	608	739	248	1595
428	0	616	819	244	1679
429	0	605	795	221	1621
430	0	613	786	220	1619
431	0	578	692	260	1530
432	0	554	735	223	1512
433	0	594	779	238	1611
434	0	651	719	268	1638
435	0	598	735	226	1559
436	0	634	750	232	1616
437	0	642	754	226	1622
438	0	572	755	226	1553
439	0	629	721	203	1553
440	0	648	721	240	1609
441	0	580	724	222	1526
442	0	589	732	225	1546
443	0	549	756	244	1549
444	0	626	741	218	1585
445	0	577	738	228	1543
446	0	553	730	241	1524
447	0	607	707	217	1531
448	0	581	754	237	1572
449	0	619	741	237	1597
450	0	586	687	224	1497
451	0	576	724	247	1547
452	0	604	722	244	1570
453	0	559	731	226	1516
454	0	563	764	225	1552
455	0	571	712	232	1515
456	0	589	731	224	1544
457	0	592	704	231	1527
458	0	520	719	232	1471
459	0	551	630	239	1420
460	0	525	672	218	1415
461	0	522	682	239	1443
462	0	574	698	233	1505
463	0	537	708	214	1459
464	0	570	706	204	1480
465	0	549	720	230	1499
466	0	544	683	233	1460
467	0	527	693	238	1458
468	0	583	728	236	1547
469	0	553	883	199	1635
470	0	553	725	229	1507
471	0	593	718	193	1504
472	0	580	752	209	1541
473	0	552	822	202	1576
474	0	598	705	207	1510
475	0	557	706	205	1468
476	0	571	689	215	1475
477	0	550	671	217	1438
478	0	563	711	203	1477
479	0	541	746	189	1476
480	0	596	684	204	1484
481	0	539	626	224	1389
482	0	566	655	221	1442
483	0	568	667	188	1423
484	0	517	691	189	1397
485	0	549	686	210	1445
486	0	562	668	224	1454
487	0	502	674	190	1366
488	0	537	665	201	1403
489	0	530	659	189	1378
490	0	546	675	235	1456
491	0	533	590	215	1338
492	0	533	666	208	1407
493	0	531	711	228	1470
494	0	566	635	192	1393
495	0	546	694	194	1434
496	0	522	623	210	1355
497	0	556	645	213	1414
498	0	587	641	217	1445
499	0	545	655	210	1410
500	0	563	657	219	1439
501	0	490	663	217	1370
502	0	550	683	200	1433
503	0	511	575	217	1303
504	0	519	611	220	1350
505	0	542	627	209	1378
506	0	524	678	239	1441
507	0	496	640	218	1354
508	0	501	577	218	1296
509	0	489	574	253	1316
510	0	477	615	258	1350
511	0	497	592	306	1395
512	0	539	628	559	1726
513	0	515	601	330	1446
514	0	529	587	202	1318
515	0	543	641	197	1381
516	0	476	636	192	1304
517	0	538	577	192	1307
518	0	495	577	220	1292
519	0	502	614	210	1326
520	0	493	579	218	1290
521	0	502	628	193	1323
522	0	493	634	204	1331
523	0	523	654	202	1379
524	0	503	612	209	1324
525	0	483	605	190	1278
526	0	529	604	197	1330
527	0	512	617	198	1327
528	0	513	633	196	1342
529	0	490	588	172	1250
530	0	503	622	186	1311
531	0	493	615	197	1305
532	0	466	619	172	1257
533	0	485	622	202	1309
534	0	476	604	205	1285
535	0	477	608	186	1271
536	0	527	619	198	1344
537	0	488	612	202	1302
538	0	503	588	182	1273
539	0	537	592	205	1334
540	0	496	621	208	1325
541	0	488	585	187	1260
542	0	496	578	189	1263
543	0	475	624	176	1275
544	0	546	594	177	1317
545	0	483	552	196	1231
546	0	443	619	193	1255
547	0	490	612	176	1278
548	0	447	582	231	1260
549	0	498	593	204	1295
550	0	521	658	196	1375
551	0	476	584	186	1246
552	0	476	623	173	1272
553	0	489	579	183	1251
554	0	465	595	188	1248
555	0	457	579	187	1223
556	0	463	586	189	1238
557	0	523	623	174	1320
558	0	459	546	184	1189
559	0	547	608	205	1360
560	0	452	533	183	1168
561	0	492	608	174	1274
562	0	487	570	163	1220
563	0	486	608	187	1281
564	0	476	580	169	1225
565	0	474	587	201	1262
566	0	498	585	183	1266
567	0	458	587	207	1252
568	0	466	602	188	1256
569	0	448	594	167	1209
570	0	474	603	181	1258
571	0	471	570	193	1234
572	0	473	562	190	1225
573	0	493	599	214	1306
574	0	482	612	178	1272
575	0	487	546	198	1231
576	0	485	561	166	1212
577	0	449	578	186	1213
578	0	444	553	184	1181
579	0	469	571	182	1222
580	0	494	596	143	1233
581	0	490	562	180	1232
582	0	472	553	176	1201
583	0	455	546	175	1176
584	0	506	588	190	1284
585	0	463	498	163	1124
586	0	427	585	167	1179
587	0	390	547	179	1116
588	0	467	565	180	1212
589	0	408	570	154	1132
590	0	457	542	173	1172
591	0	429	594	191	1214
592	0	421	545	173	1139
593	0	499	588	172	1259
594	0	433	531	171	1135
595	0	441	582	165	1188
596	0	416	565	186	1167
597	0	435	621	193	1249
598	0	464	539	187	1190
599	0	421	567	180	1168
600	0	451	565	171	1187
601	0	451	562	199	1212
602	0	462	520	156	1138
603	0	449	558	177	1184
604	0	479	533	168	1180
605	0	420	511	171	1102
606	0	465	552	175	1192
607	0	417	538	155	1110
608	0	451	539	157	1147
609	0	438	569	153	1160
610	0	392	540	153	1085
611	0	433	527	150	1110
612	0	434	510	167	1111
613	0	458	570	168	1196
614	0	408	546	183	1137
615	0	412	539	181	1132
616	0	450	598	171	1219
617	0	411	541	149	1101
618	0	397	560	154	1111
619	0	428	519	135	1082
620	0	399	520	167	1086
621	0	422	492	165	1079
622	0	408	535	172	1115
623	0	453	528	193	1174
624	0	452	503	176	1131
625	0	416	527	184	1127
626	0	392	529	179	1100
627	0	423	535	170	1128
628	0	424	515	163	1102
629	0	411	555	161	1127
630	0	390	514	176	1080
631	0	404	511	190	1105
632	0	423	524	216	1163
633	0	469	507	188	1164
634	0	403	496	195	1094
635	0	415	502	159	1076
636	0	445	546	164	1155
637	0	411	544	185	1140
638	0	423	513	153	1089
639	0	409	557	159	1125
640	0	461	511	168	1140
641	0	434	498	178	1110
642	0	463	525	168	1156
643	0	431	539	140	1110
644	0	384	521	180	1085
645	0	450	517	173	1140
646	0	404	472	182	1058
647	0	386	547	153	1086
648	0	428	502	184	1114
649	0	415	505	161	1081
650	0	403	548	153	1104
651	0	404	518	148	1070
652	0	411	533	159	1103
653	0	420	502	154	1076
654	0	395	507	159	1061
655	0	423	478	149	1050
656	0	410	512	165	1087
657	0	393	512	168	1073
658	0	393	481	154	1028
659	0	405	521	162	1088
660	0	394	486	159	1039
661	0	414	462	198	1074
662	0	394	495	149	1038
663	0	428	492	153	1073
664	0	383	493	165	1041
665	0	364	468	171	1003
666	0	378	510	140	1028
667	0	383	494	154	1031
668	0	396	515	159	1070
669	0	404	502	157	1063
670	0	398	517	168	1083
671	0	416	478	164	1058
672	0	359	467	162	988
673	0	372	497	141	1010
674	0	382	516	154	1052
675	0	359	489	148	996
676	0	382	490	168	1040
677	0	373	496	180	1049
678	0	409	450	160	1019
679	0	345	465	149	959
680	0	381	506	171	1058
681	0	403	446	205	1054
682	0	385	535	226	1146
683	0	384	474	221	1079
684	0	385	476	191	1052
685	0	399	489	211	1099
686	0	392	485	174	1051
687	0	376	476	154	1006
688	0	376	503	180	1059
689	0	391	475	158	1024
690	0	372	474	163	1009
691	0	397	462	171	1030
692	0	383	467	142	992
693	0	381	510	139	1030
694	0	388	499	144	1031
695	0	418	450	142	1010
696	0	361	481	154	996
697	0	358	492	171	1021
698	0	404	498	138	1040
699	0	366	455	136	957
700	0	403	490	137	1030
701	0	335	489	175	999
702	0	373	474	160	1007
703	0	368	487	142	997
704	0	371	489	149	1009
705	0	369	458	139	966
706	0	387	432	148	967
707	1	377	458	153	989
708	0	357	469	151	977
709	0	351	435	147	933
710	0	368	419	149	936
711	0	380	489	137	1006
712	0	409	466	149	1024
713	0	360	499	135	994
714	0	379	481	148	1008
715	0	407	487	135	1029
716	0	385	407	139	931
717	0	354	504	151	1009
718	0	367	474	145	986
719	0	383	488	125	996
720	0	365	428	147	940
721	0	371	456	153	980
722	0	323	477	170	970
723	0	382	458	155	995
724	0	344	449	127	920
725	0	351	445	127	923
726	0	353	429	136	918
727	0	341	408	141	890
728	0	332	460	131	923
729	0	378	417	144	939
730	0	332	445	150	927
731	0	350	462	147	959
732	0	337	449	146	932
733	0	367	449	146	962
734	0	355	430	133	918
735	0	357	503	143	1003
736	0	350	422	153	925
737	0	389	477	137	1003
738	0	347	474	142	963
739	0	373	440	133	946
740	0	363	441	126	930
741	0	371	404	153	928
742	0	370	462	129	961
743	0	347	469	150	966
744	0	367	419	147	933
745	0	372	419	144	935
746	0	341	419	146	906
747	0	347	436	122	905
748	0	349	458	145	952
749	0	371	415	131	917
750	0	344	461	131	936
751	0	356	417	130	903
752	0	366	438	135	939
753	0	341	427	140	908
754	0	334	390	138	862
755	0	347	424	131	902
756	0	355	424	139	918
757	0	350	443	142	935
758	0	312	422	137	871
759	0	326	436	131	893
760	0	334	414	140	888
761	0	351	424	152	927
762	0	362	430	148	940
763	0	361	436	147	944
764	0	327	409	138	874
765	0	306	426	119	851
766	0	373	427	140	940
767	0	357	414	119	890
768	0	316	431	143	890
769	0	320	427	134	881
770	0	343	432	143	918
771	0	354	435	149	938
772	0	364	395	134	893
773	0	321	417	148	886
774	0	348	416	125	889
775	0	302	408	116	826
776	0	371	421	140	932
777	0	317	455	143	915
778	0	368	414	132	914
779	0	323	404	128	855
780	0	333	378	167	878
781	0	346	430	129	905
782	0	340	410	134	884
783	0	342	401	138	881
784	0	342	402	129	873
785	0	327	438	142	907
786	0	283	427	148	858
787	0	340	417	128	885
788	0	326	379	141	846
789	0	333	443	126	902
790	0	292	409	142	843
791	0	295	417	138	850
792	0	330	429	111	870
793	0	347	384	134	865
794	0	332	396	138	866
795	0	322	388	104	814
796	0	325	391	144	860
797	0	298	430	110	838
798	0	377	437	142	956
799	0	329	395	127	851
800	0	327	391	149	867
801	0	322	408	152	882
802	0	328	425	128	881
803	0	337	399	154	890
804	0	314	404	139	857
805	0	311	396	141	848
806	0	336	434	121	891
807	0	311	389	145	845
808	0	290	367	128	785
809	0	296	404	97	797
810	0	293	410	125	828
811	0	329	392	128	849
812	0	337	386	125	848
813	0	311	412	123	846
814	0	310	388	131	829
815	0	316	403	118	837
816	0	326	398	134	858
817	0	325	369	136	830
818	0	324	386	130	840
819	0	312	418	135	865
820	0	307	405	126	838
821	0	280	399	134	813
822	0	315	362	133	810
823	0	304	357	128	789
824	0	310	415	117	842
825	0	345	393	130	868
826	0	289	414	127	830
827	0	280	402	107	789
828	0	316	385	118	819
829	0	299	394	122	815
830	0	296	379	138	813
831	0	302	415	123	840
832	0	328	392	121	841
833	0	309	416	124	849
834	0	333	415	118	866
835	0	311	411	129	851
836	0	286	363	127	776
837	0	302	396	121	819
838	0	280	388	130	798
839	0	296	367	128	791
840	0	334	398	109	841
841	0	277	365	127	769
842	0	292	373	105	770
843	0	318	405	114	837
844	0	288	385	136	809
845	0	290	380	124	794
846	0	299	380	117	796
847	0	313	379	122	814
848	0	279	357	132	768
849	0	353	396	134	883
850	0	272	363	113	748
851	0	312	409	132	853
852	0	319	392	147	858
853	0	314	365	194	873
854	0	291	375	138	804
855	0	284	394	179	857
856	0	288	377	123	788
857	0	308	362	123	793
858	0	273	411	138	822
859	0	318	340	118	776
860	0	304	372	137	813
861	0	294	343	119	756
862	0	319	384	114	817
863	0	292	360	94	746
864	0	303	381	123	807
865	0	291	379	115	785
866	0	265	339	119	723
867	0	319	380	110	809
868	0	275	381	128	784
869	0	280	356	117	753
870	0	297	389	129	815
871	0	301	382	112	795
872	0	311	361	112	784
873	0	295	337	125	757
874	0	283	372	117	772
875	0	298	359	129	786
876	0	278	341	146	765
877	0	302	368	100	770
878	0	297	379	120	796
879	0	323	368	94	785
880	0	288	337	104	729
881	0	262	360	116	738
882	0	317	404	111	832
883	0	304	364	118	786
884	0	279	355	114	748
885	0	291	331	107	729
886	0	311	378	115	804
887	0	309	351	130	790
888	0	315	376	111	802
889	0	285	323	110	718
890	0	252	347	107	706
891	0	319	358	101	778
892	0	315	321	124	760
893	0	311	367	115	793
894	0	269	383	114	766
895	0	301	379	106	786
896	0	296	353	134	783
897	0	288	361	137	786
898	0	253	381	140	774
899	0	321	358	118	797
900	0	269	367	102	738
901	0	271	397	106	774
902	0	294	314	105	713
903	0	262	367	97	726
904	0	285	355	127	767
905	0	237	351	126	714
906	0	266	347	116	729
907	0	281	352	152	785
908	0	294	344	155	793
909	0	291	361	116	768
910	0	287	362	176	825
911	0	274	344	701	1319
912	0	252	368	160	780
913	0	284	337	119	740
914	0	294	372	124	790
915	0	282	344	119	745
916	0	242	356	107	705
917	0	241	362	105	708
918	0	257	394	118	769
919	0	241	335	107	683
920	0	284	342	114	740
921	0	259	341	120	720
922	0	294	359	128	781
923	0	260	324	100	684
924	0	268	394	124	786
925	0	277	307	107	691
926	0	264	335	119	718
927	0	270	349	119	738
928	0	250	385	110	745
929	0	277	377	109	763
930	0	277	384	119	780
931	0	266	382	100	748
932	0	272	531	100	903
933	0	253	362	102	717
934	0	302	329	110	741
935	0	251	379	107	737
936	0	269	509	95	873
937	0	276	344	109	729
938	0	269	319	110	698
939	0	248	342	111	701
940	0	254	336	109	699
941	0	269	350	136	755
942	0	259	358	101	718
943	0	295	356	129	780
944	0	244	317	109	670
945	0	262	321	125	708
946	0	299	331	100	730
947	0	272	331	106	709
948	0	310	320	91	721
949	0	283	333	109	725
950	0	264	326	110	700
951	0	282	340	114	736
952	0	251	310	121	682
953	0	262	321	108	691
954	0	311	345	101	757
955	0	304	333	105	742
956	0	264	326	115	705
957	0	293	341	122	756
958	0	234	340	113	687
959	0	295	294	113	702
960	0	266	327	89	682
961	0	273	326	96	695
962	0	280	303	89	672
963	0	259	359	99	717
964	0	262	319	91	672
965	0	248	327	105	680
966	0	258	342	106	706
967	0	260	305	117	682
968	0	248	311	100	659
969	0	268	338	97	703
970	0	266	329	100	695
971	0	276	312	115	703
972	0	254	328	126	708
973	0	295	327	118	740
974	0	260	294	101	655
975	0	277	327	106	710
976	0	263	320	98	681
977	0	235	335	82	652
978	0	242	360	99	701
979	0	281	335	99	715
980	0	256	332	111	699
981	0	247	313	111	671
982	0	281	320	97	698
983	0	245	313	99	657
984	0	258	317	110	685
985	0	281	296	109	686
986	0	256	312	95	663
987	0	249	307	106	662
988	0	297	301	93	691
989	0	247	313	101	661
990	0	257	275	96	628
991	0	250	309	84	643
992	0	257	303	106	666
993	0	253	298	94	645
994	0	268	301	115	684
995	0	250	346	88	684
996	0	246	296	111	653
997	0	264	293	112	669
998	0	240	329	90	659
999	0	245	293	82	620
1000	0	248	326	101	675
1001	0	247	317	95	659
1002	0	217	321	118	656
1003	0	235	288	80	603
1004	0	245	302	102	649
1005	0	238	310	93	641
1006	0	242	268	106	616
1007	0	236	317	96	649
1008	0	261	296	84	641
1009	0	260	322	95	677
1010	0	222	291	104	617
1011	0	259	356	97	712
1012	0	248	289	101	638
1013	0	256	330	101	687
1014	0	250	333	96	679
1015	0	226	276	95	597
1016	0	255	307	106	668
1017	0	237	276	103	616
1018	0	252	276	103	631
1019	0	253	317	83	653
1020	0	241	272	124	637
1021	0	226	328	82	636
1022	0	250	282	103	635
1023	0	248	282	106	636
1024	0	250	297	117	664
1025	0	237	314	120	671
1026	0	262	283	104	649
1027	0	227	268	125	620
1028	0	239	297	100	636
1029	0	228	309	109	646
1030	0	234	296	100	630
1031	0	255	308	122	685
1032	0	267	273	107	647
1033	0	273	290	110	673
1034	0	264	258	111	633
1035	0	220	286	107	613
1036	0	246	275	92	613
1037	0	199	280	100	579
1038	0	243	299	97	639
1039	0	249	319	96	664
1040	0	214	326	109	649
1041	0	257	284	90	631
1042	0	260	269	96	625
1043	0	218	301	78	597
1044	0	223	267	94	584
1045	0	229	301	73	603
1046	0	231	299	85	615
1047	0	250	288	90	628
1048	0	206	275	89	570
1049	0	207	296	93	596
1050	0	230	283	85	598
1051	0	213	292	86	591
1052	0	234	301	84	619
1053	0	227	303	94	624
1054	0	246	313	76	635
1055	0	232	320	76	628
1056	0	246	313	99	658
1057	0	252	289	76	617
1058	0	224	272	98	594
1059	0	229	299	72	600
1060	0	234	272	95	601
1061	0	227	269	104	600
1062	0	223	290	74	587
1063	0	208	289	79	576
1064	0	241	288	92	621
1065	0	226	290	96	612
1066	0	220	297	98	615
1067	0	240	325	97	662
1068	0	219	302	90	611
1069	0	246	272	99	617
1070	0	244	307	83	634
1071	0	223	292	95	610
1072	0	219	301	82	602
1073	0	201	328	85	614
1074	0	211	277	97	585
1075	0	221	269	91	581
1076	0	243	291	78	612
1077	0	263	294	82	639
1078	0	234	273	87	594
1079	0	225	278	80	583
1080	0	203	297	100	600
1081	0	210	274	110	594
1082	0	242	298	92	632
1083	0	233	258	86	577
1084	0	197	277	97	571
1085	0	219	272	86	577
1086	0	251	292	114	657
1087	0	187	278	101	566
1088	0	206	271	89	566
1089	0	218	254	91	563
1090	0	201	298	103	602
1091	0	239	290	94	623
1092	0	238	257	90	585
1093	0	207	284	106	597
1094	0	200	296	101	597
1095	0	229	280	81	590
1096	0	211	253	84	548
1097	0	234	285	92	611
1098	0	227	285	89	601
1099	0	220	260	76	556
1100	0	214	288	79	581
1101	0	249	296	78	623
1102	0	226	270	103	599
1103	0	223	263	78	564
1104	0	234	265	74	573
1105	0	234	289	85	608
1106	0	222	284	99	605
1107	0	227	266	80	573
1108	0	239	268	83	590
1109	0	228	285	77	590
1110	0	216	305	87	608
1111	0	211	276	108	595
1112	0	212	246	82	540
1113	0	233	271	81	585
1114	0	231	252	71	554
1115	0	222	223	87	532
1116	0	219	267	91	577
1117	0	227	249	84	560
1118	0	228	280	83	591
1119	0	219	273	98	590
1120	0	238	271	91	600
1121	0	208	279	103	590
1122	0	216	256	73	545
1123	0	236	280	86	602
1124	0	227	303	91	621
1125	0	222	275	73	570
1126	0	223	259	94	576
1127	0	207	252	89	548
1128	0	213	263	101	577
1129	0	201	253	76	530
1130	0	211	261	87	559
1131	0	231	266	88	585
1132	0	238	255	71	564
1133	0	191	274	87	552
1134	0	195	279	82	556
1135	0	222	276	93	591
1136	0	184	269	73	526
1137	0	205	252	89	546
1138	0	207	267	68	542
1139	0	195	265	107	567
1140	0	237	285	77	599
1141	0	219	276	82	577
1142	0	220	239	84	543
1143	0	225	272	87	584
1144	0	203	266	79	548
1145	0	210	244	81	535
1146	0	195	252	102	549
1147	0	207	260	91	558
1148	0	211	243	75	529
1149	0	215	244	66	525
1150	0	172	267	93	532
1151	0	204	259	86	549
1152	0	172	237	75	484
1153	0	208	238	71	517
1154	0	213	236	92	541
1155	0	236	265	81	582
1156	0	195	231	68	494
1157	0	220	238	69	527
1158	0	205	258	74	537
1159	0	241	285	78	604
1160	0	198	263	71	532
1161	0	220	278	74	572
1162	0	216	263	82	561
1163	0	201	253	73	527
1164	0	191	241	85	517
1165	0	226	245	78	549
1166	0	191	250	98	539
1167	0	198	248	96	542
1168	0	189	256	97	542
1169	0	215	279	80	574
1170	0	214	258	75	547
1171	0	211	238	92	541
1172	0	184	243	69	496
1173	0	222	258	89	569
1174	0	227	250	86	563
1175	0	208	272	72	552
1176	0	211	240	86	537
1177	0	173	276	85	534
1178	0	205	264	69	538
1179	0	179	245	86	510
1180	0	186	234	101	521
1181	0	225	243	79	547
1182	0	195	249	83	527
1183	0	187	233	84	504
1184	0	211	234	84	529
1185	0	193	232	79	504
1186	0	176	224	76	476
1187	0	204	250	94	548
1188	0	205	261	81	547
1189	0	190	254	85	529
1190	0	198	232	104	534
1191	0	206	227	77	510
1192	0	215	252	95	562
1193	0	208	250	87	545
1194	0	196	252	105	553
1195	0	199	252	88	539
1196	0	165	242	75	482
1197	0	186	252	121	559
1198	0	198	255	75	528
1199	0	196	241	75	512
1200	0	213	212	84	509
1201	0	205	260	78	543
1202	0	167	236	93	496
1203	0	172	264	62	498
1204	0	213	258	67	538
1205	0	187	268	68	523
1206	0	179	222	81	482
1207	0	176	225	72	473
1208	0	195	246	85	526
1209	0	177	240	69	486
1210	0	201	212	69	482
1211	0	191	274	69	534
1212	0	202	248	80	530
1213	0	181	232	86	499
1214	0	185	238	82	505
1215	0	209	234	75	518
1216	0	177	237	68	482
1217	0	167	224	73	464
1218	0	192	242	79	513
1219	0	180	267	63	510
1220	0	207	233	78	518
1221	0	180	217	77	474
1222	0	201	211	78	490
1223	0	194	244	87	525
1224	0	195	249	75	519
1225	0	186	261	78	525
1226	0	167	250	81	498
1227	0	184	264	86	534
1228	0	192	262	60	514
1229	0	178	225	82	485
1230	0	197	235	71	503
1231	0	220	246	68	534
1232	0	189	232	80	501
1233	0	207	246	90	543
1234	0	173	241	65	479
1235	0	178	257	83	518
1236	0	210	248	55	513
1237	0	215	237	73	525
1238	0	213	226	86	525
1239	0	166	227	75	468
1240	0	199	244	89	532
1241	0	198	242	82	522
1242	0	198	265	79	542
1243	0	233	231	81	545
1244	0	232	220	80	532
1245	0	205	247	74	526
1246	0	185	205	69	459
1247	0	188	260	73	521
1248	0	176	241	80	497
1249	0	186	219	88	493
1250	0	197	206	76	479
1251	0	181	244	73	498
1252	0	179	224	65	468
1253	0	195	240	71	506
1254	0	215	250	70	535
1255	0	193	212	72	477
1256	0	189	199	60	448
1257	0	171	244	75	490
1258	0	184	217	77	478
1259	0	214	246	70	530
1260	0	165	219	65	449
1261	0	172	234	65	471
1262	0	176	224	60	460
1263	0	191	210	56	457
1264	0	214	251	74	539
1265	0	169	232	81	482
1266	0	197	223	70	490
1267	0	176	236	56	468
1268	0	184	233	72	489
1269	0	163	233	62	458
1270	0	194	238	74	506
1271	0	195	226	63	484
1272	0	165	199	70	434
1273	0	203	214	68	485
1274	0	177	227	62	466
1275	0	200	216	86	502
1276	0	191	213	63	467
1277	0	180	238	84	502
1278	0	175	245	61	481
1279	0	178	242	65	485
1280	0	187	217	73	477
1281	0	188	205	56	449
1282	0	165	232	74	471
1283	0	192	223	63	478
1284	0	180	238	63	481
1285	0	181	221	70	472
1286	0	194	248	60	502
1287	0	172	229	71	472
1288	0	199	230	81	510
1289	0	182	267	57	506
1290	0	199	228	68	495
1291	0	149	251	66	466
1292	0	182	232	62	476
1293	0	178	233	72	483
1294	0	206	225	67	498
1295	0	170	237	79	486
1296	0	174	235	71	480
1297	0	177	214	61	452
1298	0	177	229	78	484
1299	0	174	212	75	461
1300	0	170	220	60	450
1301	0	178	244	75	497
1302	0	151	237	62	450
1303	0	163	204	58	425
1304	0	179	196	59	434
1305	0	188	244	74	506
1306	0	163	222	77	462
1307	0	165	209	85	459
1308	0	182	211	63	456
1309	0	166	229	75	470
1310	0	186	195	73	454
1311	0	151	219	70	440
1312	0	180	231	79	490
1313	0	174	207	61	442
1314	0	190	223	59	472
1315	0	172	229	61	462
1316	0	178	224	66	468
1317	0	159	229	78	466
1318	0	155	216	69	440
1319	0	186	205	59	450
1320	0	160	217	65	442
1321	0	154	214	66	434
1322	0	195	207	63	465
1323	0	162	218	71	451
1324	0	140	245	61	446
1325	0	180	202	74	456
1326	0	173	224	63	460
1327	0	184	205	77	466
1328	0	184	200	78	462
1329	0	175	237	90	502
1330	0	177	213	61	451
1331	0	149	221	65	435
1332	0	183	209	76	468
1333	0	159	221	77	457
1334	0	167	220	70	457
1335	0	180	221	61	462
1336	0	169	248	68	485
1337	0	155	216	73	444
1338	0	170	198	69	437
1339	0	174	209	54	437
1340	0	184	209	72	465
1341	0	163	199	62	424
1342	0	156	199	65	420
1343	0	168	231	67	466
1344	0	156	212	70	438
1345	0	162	238	76	476
1346	0	163	211	64	438
1347	0	172	196	71	439
1348	0	166	187	62	415
1349	0	173	203	68	444
1350	0	152	222	59	433
1351	0	155	209	67	431
1352	0	145	232	53	430
1353	0	157	197	69	423
1354	0	156	214	69	439
1355	0	158	220	59	437
1356	0	164	233	68	465
1357	0	152	193	72	417
1358	0	160	185	77	422
1359	0	151	218	51	420
1360	0	170	219	66	455
1361	0	146	200	74	420
1362	0	147	216	73	436
1363	0	156	211	81	448
1364	0	178	195	72	445
1365	0	176	195	81	452
1366	0	157	196	69	422
1367	0	165	193	75	433
1368	0	150	214	65	429
1369	0	172	232	54	458
1370	0	175	235	62	472
1371	0	171	184	66	421
1372	0	167	201	78	446
1373	0	143	206	71	420
1374	0	152	217	59	428
1375	0	158	203	62	423
1376	0	156	211	74	441
1377	0	171	216	63	450
1378	0	152	200	59	411
1379	0	147	195	67	409
1380	0	174	231	70	475
1381	0	140	205	64	409
1382	0	147	208	63	418
1383	0	183	213	80	476
1384	0	155	254	63	472
1385	0	152	182	49	383
1386	0	169	191	63	423
1387	0	168	208	59	435
1388	0	143	169	65	377
1389	0	159	184	60	403
1390	0	182	196	67	445
1391	0	164	194	55	413
1392	0	153	198	71	422
1393	0	184	187	63	434
1394	0	147	192	65	404
1395	0	163	193	60	416
1396	0	142	178	56	376
1397	0	157	211	65	433
1398	0	163	205	63	431
1399	0	150	213	65	428
1400	0	124	202	67	393
1401	0	168	195	73	436
1402	0	152	207	50	409
1403	0	146	180	51	377
1404	0	133	218	73	424
1405	0	186	202	69	457
1406	0	132	201	73	406
1407	0	113	207	71	391
1408	0	145	190	73	408
1409	0	151	184	67	402
1410	0	135	161	69	365
1411	0	133	187	69	389
1412	0	137	195	61	393
1413	0	160	192	79	431
1414	0	141	200	67	408
1415	0	132	206	57	395
1416	0	152	186	64	402
1417	0	187	197	60	444
1418	0	158	208	50	416
1419	0	163	185	62	410
1420	0	143	179	67	389
1421	0	157	195	77	429
1422	0	160	211	85	456
1423	0	145	187	136	468
1424	0	147	202	77	426
1425	0	158	198	48	404
1426	0	148	196	55	399
1427	0	125	182	69	376
1428	0	164	199	74	437
1429	0	145	196	72	413
1430	0	155	180	71	406
1431	0	152	186	79	417
1432	0	130	185	57	372
1433	0	166	180	73	419
1434	0	149	199	62	410
1435	0	160	197	54	411
1436	0	151	205	58	414
1437	0	165	218	60	443
1438	0	134	195	71	400
1439	0	150	203	73	426
1440	0	142	203	69	414
1441	0	182	156	72	410
1442	0	139	216	60	415
1443	0	147	192	38	377
1444	0	169	199	62	430
1445	0	174	221	56	451
1446	0	146	187	61	394
1447	0	133	189	49	371
1448	0	138	202	61	401
1449	0	135	195	62	392
1450	0	167	212	59	438
1451	0	151	177	66	394
1452	0	128	179	72	379
1453	0	151	168	65	384
1454	0	150	182	73	405
1455	0	144	177	68	389
1456	0	132	169	67	368
1457	0	148	190	72	410
1458	0	137	177	55	369
1459	0	153	198	52	403
1460	0	156	183	69	408
1461	0	174	188	55	417
1462	0	148	218	51	417
1463	0	161	191	49	401
1464	0	133	182	55	370
1465	0	151	182	60	393
1466	0	142	198	75	415
1467	0	150	195	64	409
1468	0	146	189	64	399
1469	0	145	187	53	385
1470	0	139	191	49	379
1471	0	150	180	50	380
1472	0	140	181	51	372
1473	0	133	198	56	387
1474	0	155	210	56	421
1475	0	133	169	60	362
1476	0	143	179	57	379
1477	0	171	189	62	422
1478	0	133	175	51	359
1479	0	157	202	59	418
1480	0	165	169	62	396
1481	0	149	180	50	379
1482	0	140	180	59	379
1483	0	155	172	64	391
1484	0	151	162	48	361
1485	0	145	170	59	374
1486	0	129	172	54	355
1487	0	124	189	64	377
1488	0	156	183	53	392
1489	0	157	183	49	389
1490	0	143	195	72	410
1491	0	151	178	59	388
1492	0	156	162	48	366
1493	0	145	159	62	366
1494	0	135	172	43	350
1495	0	137	195	68	400
1496	0	157	190	71	418
1497	0	157	194	57	408
1498	0	163	173	62	398
1499	0	147	167	55	369
1500	0	152	172	68	392
1501	0	137	177	47	361
1502	0	142	185	61	388
1503	0	152	203	56	411
1504	0	122	181	57	360
1505	0	125	190	55	370
1506	0	128	185	54	367
1507	0	147	185	59	391
1508	0	135	178	55	368
1509	0	143	184	58	385
1510	0	150	170	38	358
1511	0	140	183	43	366
1512	0	144	175	62	381
1513	0	142	208	56	406
1514	0	156	143	55	354
1515	0	150	198	50	398
1516	0	153	179	53	385
1517	0	141	190	58	389
1518	0	132	181	71	384
1519	0	135	176	53	364
1520	0	140	183	61	384
1521	0	158	188	61	407
1522	0	117	177	54	348
1523	0	136	164	59	359
1524	0	142	185	62	389
1525	0	149	175	54	378
1526	0	125	188	54	367
1527	0	133	178	55	366
1528	0	140	188	52	380
1529	0	139	159	63	361
1530	0	143	137	59	339
1531	0	133	175	75	383
1532	0	168	194	44	406
1533	0	143	180	82	405
1534	0	140	157	43	340
1535	0	161	180	58	399
1536	0	135	198	59	392
1537	0	134	186	45	365
1538	0	138	155	39	332
1539	0	160	184	49	393
1540	0	156	163	51	370
1541	0	140	156	70	366
1542	0	137	182	52	371
1543	0	144	154	57	355
1544	0	139	170	62	371
1545	0	146	180	55	381
1546	0	153	156	71	380
1547	0	151	180	45	376
1548	0	158	160	44	362
1549	0	132	174	60	366
1550	0	127	159	50	336
1551	0	147	167	48	362
1552	0	128	174	63	365
1553	0	146	152	67	365
1554	0	149	155	53	357
1555	0	142	174	61	377
1556	0	134	172	54	360
1557	0	148	178	54	380
1558	0	161	175	62	398
1559	0	125	155	64	344
1560	0	143	176	58	377
1561	0	122	186	52	360
1562	0	120	187	59	366
1563	0	120	182	57	359
1564	0	121	185	52	358
1565	0	144	163	65	372
1566	0	120	158	51	329
1567	0	125	180	65	370
1568	0	135	168	52	355
1569	0	156	162	44	362
1570	0	120	173	49	342
1571	0	130	154	64	348
1572	0	141	153	60	354
1573	0	144	172	64	380
1574	0	131	165	57	353
1575	0	127	168	62	357
1576	0	157	155	58	370
1577	0	133	182	49	364
1578	0	153	149	57	359
1579	0	128	178	49	355
1580	0	126	161	54	341
1581	0	138	180	55	373
1582	0	125	151	53	329
1583	0	123	164	46	333
1584	0	135	181	52	368
1585	0	157	136	52	345
1586	0	136	154	58	348
1587	0	141	147	54	342
1588	0	123	165	42	330
1589	0	115	173	48	336
1590	0	129	164	51	344
1591	0	141	147	58	346
1592	0	119	168	56	343
1593	0	124	171	61	356
1594	0	127	150	61	338
1595	0	151	160	57	368
1596	0	130	159	62	351
1597	0	133	160	48	341
1598	0	135	184	56	375
1599	0	142	177	34	353
1600	0	103	170	47	320
1601	0	131	167	46	344
1602	0	152	173	63	388
1603	0	141	160	70	371
1604	0	131	179	43	353
1605	0	104	159	42	305
1606	0	136	183	46	365
1607	0	126	162	51	339
1608	0	111	185	58	354
1609	0	119	148	55	322
1610	0	128	158	49	335
1611	0	128	148	46	322
1612	0	123	191	59	373
1613	0	148	174	49	371
1614	0	134	169	48	351
1615	0	107	160	54	321
1616	0	132	165	53	350
1617	0	127	140	57	324
1618	0	130	157	56	343
1619	0	119	178	62	359
1620	0	127	168	68	363
1621	0	110	184	55	349
1622	0	148	167	48	363
1623	0	114	163	57	334
1624	0	139	176	51	366
1625	0	136	164	59	359
1626	0	132	175	50	357
1627	0	136	151	55	342
1628	0	132	173	52	357
1629	0	133	149	40	322
1630	0	114	154	42	310
1631	0	120	168	65	353
1632	0	136	158	56	350
1633	0	127	158	57	342
1634	0	126	165	48	339
1635	0	115	155	47	317
1636	0	117	170	48	335
1637	0	118	173	53	344
1638	0	113	136	60	309
1639	0	117	182	59	358
1640	0	149	164	57	370
1641	0	129	136	44	309
1642	0	125	171	44	340
1643	0	124	163	32	319
1644	0	133	150	54	337
1645	0	130	165	36	331
1646	0	134	185	42	361
1647	0	105	176	42	323
1648	0	146	153	46	345
1649	0	127	147	61	335
1650	0	118	129	63	310
1651	0	144	181	57	382
1652	0	153	169	46	368
1653	0	194	138	55	387
1654	0	174	150	44	368
1655	0	181	148	43	372
1656	0	206	138	52	396
1657	0	617	137	44	798
1658	0	177	141	46	364
1659	0	138	175	57	370
1660	0	136	164	47	347
1661	0	120	126	57	303
1662	0	134	164	47	345
1663	0	132	159	44	335
1664	0	108	139	45	292
1665	0	125	142	59	326
1666	0	119	146	50	315
1667	0	107	149	51	307
1668	0	143	148	53	344
1669	0	119	142	50	311
1670	0	109	150	51	310
1671	0	125	138	49	312
1672	0	124	166	44	334
1673	0	136	175	56	367
1674	0	108	143	47	298
1675	0	123	182	45	350
1676	0	108	152	40	300
1677	0	105	151	46	302
1678	0	130	215	52	397
1679	0	129	183	43	355
1680	0	107	174	55	336
1681	0	119	184	60	363
1682	0	124	181	47	352
1683	0	138	175	45	358
1684	0	122	144	63	329
1685	0	144	162	62	368
1686	0	124	157	48	329
1687	0	113	154	46	313
1688	0	100	148	51	299
1689	0	104	153	45	302
1690	0	123	140	54	317
1691	0	104	130	44	278
1692	0	111	120	58	289
1693	0	110	161	41	312
1694	0	119	146	59	324
1695	0	116	154	37	307
1696	0	95	130	46	271
1697	0	122	157	48	327
1698	0	113	126	50	289
1699	0	125	158	44	327
1700	0	115	128	56	299
1701	0	106	157	60	323
1702	0	121	164	53	338
1703	0	125	142	57	324
1704	0	108	119	53	280
1705	0	112	133	49	294
1706	0	120	148	54	322
1707	0	116	171	46	333
1708	0	106	138	43	287
1709	0	112	154	63	329
1710	0	131	136	35	302
1711	0	117	130	43	290
1712	0	141	139	55	335
1713	0	101	147	47	295
1714	0	134	177	53	364
1715	0	118	142	57	317
1716	0	130	152	44	326
1717	0	105	137	65	307
1718	0	120	153	37	310
1719	0	125	155	40	320
1720	0	140	133	43	316
1721	0	105	133	67	305
1722	0	120	169	46	335
1723	0	118	140	47	305
1724	0	127	152	43	322
1725	0	117	174	46	337
1726	0	117	168	56	341
1727	0	122	158	34	314
1728	0	118	153	53	324
1729	0	118	173	45	336
1730	0	87	125	44	256
1731	0	115	167	39	321
1732	0	109	142	50	301
1733	0	125	145	42	312
1734	0	110	133	52	295
1735	0	119	126	45	290
1736	0	112	174	39	325
1737	0	122	161	48	331
1738	0	113	162	52	327
1739	0	120	142	56	318
1740	0	110	135	39	284
1741	0	111	146	46	303
1742	0	106	163	56	325
1743	0	107	147	49	303
1744	0	101	162	51	314
1745	0	125	156	40	321
1746	0	120	123	61	304
1747	0	113	134	33	280
1748	0	93	140	46	279
1749	0	100	135	75	310
1750	0	101	143	61	305
1751	0	99	152	34	285
1752	0	114	152	46	312
1753	0	109	173	45	327
1754	0	118	137	47	302
1755	0	95	146	55	296
1756	0	97	159	35	291
1757	0	108	136	41	285
1758	0	102	141	34	277
1759	0	116	169	46	331
1760	0	105	134	46	285
1761	0	118	143	42	303
1762	0	98	130	60	288
1763	0	120	127	41	288
1764	0	116	147	50	313
1765	0	108	138	41	287
1766	0	122	154	52	328
1767	0	105	136	45	286
1768	0	105	129	55	289
1769	0	110	125	53	288
1770	0	106	134	45	285
1771	0	113	124	46	283
1772	0	117	132	54	303
1773	0	99	144	49	292
1774	0	109	149	48	306
1775	0	109	158	41	308
1776	0	113	113	44	270
1777	0	110	167	48	325
1778	0	89	157	34	280
1779	0	114	126	39	279
1780	0	98	121	47	266
1781	0	111	127	46	284
1782	0	91	138	38	267
1783	0	109	142	50	301
1784	0	116	122	46	284
1785	0	120	138	45	303
1786	0	123	129	46	298
1787	0	105	119	50	274
1788	0	92	125	49	266
1789	0	117	126	44	287
1790	0	130	144	47	321
1791	0	92	167	44	303
1792	0	122	159	43	324
1793	0	102	128	46	276
1794	0	93	149	44	286
1795	0	101	170	40	311
1796	0	126	148	35	309
1797	0	122	161	37	320
1798	0	96	137	40	273
1799	0	91	134	44	269
1800	0	111	134	29	274
1801	0	102	148	42	292
1802	0	96	134	40	270
1803	0	117	135	43	295
1804	0	111	125	46	282
1805	0	114	133	40	287
1806	0	97	147	40	284
1807	0	97	134	31	262
1808	0	94	138	43	275
1809	0	104	129	46	279
1810	0	99	124	50	273
1811	0	112	126	33	271
1812	0	114	122	47	283
1813	0	117	128	42	287
1814	0	123	141	38	302
1815	0	119	136	42	297
1816	0	97	139	48	284
1817	0	103	130	40	273
1818	0	116	129	49	294
1819	0	110	144	34	288
1820	0	100	140	37	277
1821	0	101	125	54	280
1822	0	100	128	40	268
1823	0	100	139	45	284
1824	0	128	126	52	306
1825	0	107	125	36	268
1826	0	113	134	39	286
1827	0	104	147	37	288
1828	0	82	133	40	255
1829	0	104	143	52	299
1830	0	89	131	41	261
1831	0	121	123	49	293
1832	0	113	136	46	295
1833	0	122	139	43	304
1834	0	93	150	38	281
1835	0	93	117	50	260
1836	0	106	134	27	267
1837	0	93	109	36	238
1838	0	110	129	48	287
1839	0	116	118	33	267
1840	0	120	135	43	298
1841	0	119	124	45	288
1842	0	103	147	37	287
1843	0	108	126	35	269
1844	0	106	133	41	280
1845	0	103	140	48	291
1846	0	107	154	35	296
1847	0	95	136	39	270
1848	0	100	123	33	256
1849	0	100	143	33	276
1850	0	109	147	40	296
1851	0	105	120	39	264
1852	0	93	132	47	272
1853	0	96	123	44	263
1854	0	110	133	44	287
1855	0	103	136	39	278
1856	0	83	107	42	232
1857	0	101	122	38	261
1858	0	99	110	35	244
1859	0	118	116	47	281
1860	0	110	136	37	283
1861	0	106	139	45	290
1862	0	103	108	44	255
1863	0	108	132	37	277
1864	0	115	115	29	259
1865	0	117	125	48	290
1866	0	100	128	48	276
1867	0	120	130	37	287
1868	0	110	129	45	284
1869	0	112	128	38	278
1870	0	96	116	54	266
1871	0	110	133	44	287
1872	0	90	129	38	257
1873	0	100	154	41	295
1874	0	110	119	62	291
1875	0	97	161	41	299
1876	0	92	116	50	258
1877	0	112	120	45	277
1878	0	105	149	34	288
1879	0	106	149	46	301
1880	0	77	126	47	250
1881	0	104	124	37	265
1882	0	97	148	49	294
1883	0	103	100	41	244
1884	0	100	112	48	260
1885	0	100	103	45	248
1886	0	100	120	42	262
1887	0	125	125	40	290
1888	0	89	136	33	258
1889	0	112	130	34	276
1890	0	94	121	32	247
1891	0	82	116	51	249
1892	0	106	141	42	289
1893	0	100	159	31	290
1894	0	94	134	15	243
1895	0	93	108	41	242
1896	0	96	126	38	260
1897	0	100	138	45	283
1898	0	111	122	40	273
1899	0	115	123	46	284
1900	0	107	107	37	251
1901	0	87	137	46	270
1902	0	104	124	35	263
1903	0	104	120	47	271
1904	0	72	123	43	238
1905	0	111	105	39	255
1906	0	118	114	38	270
1907	0	107	127	43	277
1908	0	97	134	42	273
1909	0	108	111	36	255
1910	0	86	120	36	242
1911	0	96	118	45	259
1912	0	95	106	35	236
1913	0	97	117	42	256
1914	0	112	124	51	287
1915	0	110	122	29	261
1916	0	99	119	37	255
1917	0	109	135	37	281
1918	0	99	125	36	260
1919	0	101	110	46	257
1920	0	97	123	41	261
1921	0	97	117	35	249
1922	0	100	120	37	257
1923	0	83	137	47	267
1924	0	95	138	35	268
1925	0	96	115	40	251
1926	0	90	138	38	266
1927	0	102	114	43	259
1928	0	91	120	29	240
1929	0	85	123	49	257
1930	0	91	139	29	259
1931	0	97	130	36	263
1932	0	84	128	35	247
1933	0	102	121	41	264
1934	0	105	135	52	292
1935	0	92	105	40	237
1936	0	94	120	30	244
1937	0	116	143	35	294
1938	0	104	132	38	274
1939	0	91	131	28	250
1940	0	103	140	47	290
1941	0	92	113	38	243
1942	0	105	132	43	280
1943	0	95	119	48	262
1944	0	86	114	41	241
1945	0	110	124	50	284
1946	0	114	116	37	267
1947	0	91	107	38	236
1948	0	80	110	40	230
1949	0	96	111	46	253
1950	0	84	118	45	247
1951	0	97	119	37	253
1952	0	89	122	40	251
1953	0	112	105	42	259
1954	0	82	108	24	214
1955	0	96	129	37	262
1956	0	106	121	36	263
1957	0	103	116	43	262
1958	0	88	126	35	249
1959	0	84	129	35	248
1960	0	78	105	31	214
1961	0	102	101	31	234
1962	0	102	120	43	265
1963	0	86	114	34	234
1964	0	97	128	38	263
1965	0	84	132	28	244
1966	0	95	99	30	224
1967	0	95	135	34	264
1968	0	95	134	41	270
1969	0	91	123	27	241
1970	0	99	113	37	249
1971	0	101	107	35	243
1972	0	101	124	44	269
1973	0	82	132	40	254
1974	0	75	116	36	227
1975	0	105	117	26	248
1976	0	88	122	33	243
1977	0	76	101	44	221
1978	0	92	109	36	237
1979	0	110	114	37	261
1980	0	104	136	37	277
1981	0	86	131	40	257
1982	0	94	122	30	246
1983	0	85	102	36	223
1984	0	88	131	42	261
1985	0	68	128	37	233
1986	0	92	127	40	259
1987	0	85	129	46	260
1988	0	103	125	37	265
1989	0	108	146	34	288
1990	0	92	117	41	250
1991	0	88	117	39	244
1992	0	87	108	43	238
1993	0	80	149	45	274
1994	0	83	114	34	231
1995	0	91	135	31	257
1996	0	96	117	38	251
1997	0	88	89	32	209
1998	0	81	93	29	203
1999	0	83	124	35	242
2000	0	98	116	50	264
2001	0	88	110	43	241
2002	0	116	123	46	285
2003	0	91	102	31	224
2004	0	108	125	33	266
2005	0	79	123	32	234
2006	0	93	113	33	239
2007	0	104	138	32	274
2008	0	81	114	28	223
2009	0	82	98	33	213
2010	0	89	111	33	233
2011	0	104	111	33	248
2012	0	93	97	33	223
2013	0	93	122	40	255
2014	0	92	116	40	248
2015	0	114	108	40	262
2016	0	68	105	34	207
2017	0	95	133	46	274
2018	0	90	132	40	262
2019	0	92	127	38	257
2020	0	102	113	31	246
2021	0	65	102	36	203
2022	0	74	104	37	215
2023	0	89	101	39	229
2024	0	90	104	42	236
2025	0	99	105	33	237
2026	0	100	114	34	248
2027	0	85	135	29	249
2028	0	85	118	40	243
2029	0	87	111	39	237
2030	0	111	123	29	263
2031	0	103	104	43	250
2032	0	94	146	39	279
2033	0	85	124	51	260
2034	0	89	123	30	242
2035	0	85	136	47	268
2036	0	94	125	30	249
2037	0	73	141	38	252
2038	0	88	112	31	231
2039	0	95	96	49	240
2040	0	81	113	36	230
2041	0	88	110	34	232
2042	0	75	118	33	226
2043	0	77	104	30	211
2044	0	82	107	56	245
2045	0	90	110	40	240
2046	0	100	114	42	256
2047	0	93	85	41	219
2048	0	77	121	40	238
2049	0	88	110	28	226
2050	0	88	104	36	228
2051	0	89	102	39	230
2052	0	78	132	33	243
2053	0	71	115	27	213
2054	0	96	106	35	237
2055	0	95	115	48	258
2056	0	78	115	36	229
2057	0	88	124	32	244
2058	0	65	102	27	194
2059	0	83	89	51	223
2060	0	89	96	38	223
2061	0	76	108	36	220
2062	0	99	106	41	246
2063	0	82	107	34	223
2064	0	63	103	37	203
2065	0	94	102	25	221
2066	0	66	121	31	218
2067	0	73	111	43	227
2068	0	94	89	30	213
2069	0	96	115	37	248
2070	0	73	95	38	206
2071	0	86	89	35	210
2072	0	87	123	40	250
2073	0	91	112	24	227
2074	0	98	93	34	225
2075	0	96	110	44	250
2076	0	100	118	38	256
2077	0	77	113	30	220
2078	0	83	111	41	235
2079	0	86	121	27	234
2080	0	85	107	31	223
2081	0	101	106	26	233
2082	0	89	116	40	245
2083	0	77	90	38	205
2084	0	70	112	45	227
2085	0	104	118	32	254
2086	0	86	100	39	225
2087	0	76	100	32	208
2088	0	77	105	36	218
2089	0	82	105	34	221
2090	0	85	108	36	229
2091	0	91	121	28	240
2092	0	91	105	23	219
2093	0	89	99	46	234
2094	0	98	116	33	247
2095	0	74	107	22	203
2096	0	87	125	28	240
2097	0	96	102	37	235
2098	0	86	106	39	231
2099	0	89	89	29	207
2100	0	83	108	28	219
2101	0	91	104	33	228
2102	0	86	112	37	235
2103	0	71	94	40	205
2104	0	64	98	30	192
2105	0	78	96	34	208
2106	0	112	103	38	253
2107	0	109	111	28	248
2108	0	72	117	24	213
2109	0	81	107	32	220
2110	0	98	99	37	234
2111	0	68	122	35	225
2112	0	86	104	33	223
2113	0	88	90	38	216
2114	0	81	97	36	214
2115	0	88	103	35	226
2116	0	91	90	46	227
2117	0	83	121	24	228
2118	0	77	112	28	217
2119	0	91	113	32	236
2120	0	88	98	34	220
2121	0	84	97	34	215
2122	0	77	112	36	225
2123	0	84	110	42	236
2124	0	86	96	24	206
2125	0	92	101	33	226
2126	0	91	100	24	215
2127	0	71	103	25	199
2128	0	74	95	31	200
2129	0	92	109	31	232
2130	0	74	116	36	226
2131	0	91	91	36	218
2132	0	68	115	31	214
2133	0	82	93	39	214
2134	0	81	128	45	254
2135	0	82	107	29	218
2136	0	85	97	27	209
2137	0	87	120	22	229
2138	0	99	76	30	205
2139	0	81	91	25	197
2140	0	87	121	34	242
2141	0	85	119	29	233
2142	0	73	84	33	190
2143	0	85	118	39	242
2144	0	87	97	34	218
2145	0	69	104	35	208
2146	0	77	112	25	214
2147	0	80	87	35	202
2148	0	73	95	36	204
2149	0	81	105	34	220
2150	0	85	118	35	238
2151	0	88	94	42	224
2152	0	76	106	28	210
2153	0	82	102	30	214
2154	0	78	95	35	208
2155	0	80	89	33	202
2156	0	71	100	30	201
2157	0	62	111	26	199
2158	0	86	100	37	223
2159	0	73	111	34	218
2160	0	74	88	29	191
2161	0	89	95	31	215
2162	0	94	109	32	235
2163	0	73	96	41	210
2164	0	84	99	33	216
2165	0	94	84	35	213
2166	0	74	120	35	229
2167	0	74	109	38	221
2168	0	73	96	47	216
2169	0	94	129	38	261
2170	0	73	102	35	210
2171	0	70	95	30	195
2172	0	73	94	34	201
2173	0	81	101	21	203
2174	0	72	81	31	184
2175	0	84	116	24	224
2176	0	76	93	39	208
2177	0	80	100	36	216
2178	0	75	98	30	203
2179	0	91	88	32	211
2180	0	58	89	26	173
2181	0	86	104	35	225
2182	0	86	97	27	210
2183	0	70	86	30	186
2184	0	65	98	32	195
2185	0	79	90	39	208
2186	0	66	88	28	182
2187	0	80	96	29	205
2188	0	79	98	32	209
2189	0	84	97	25	206
2190	0	84	111	39	234
2191	0	86	94	38	218
2192	0	69	101	31	201
2193	0	84	89	32	205
2194	0	79	94	40	213
2195	0	79	90	33	202
2196	0	72	95	30	197
2197	0	76	93	31	200
2198	0	78	101	33	212
2199	0	83	99	30	212
2200	0	71	97	27	195
2201	0	86	89	26	201
2202	0	88	103	24	215
2203	0	80	126	35	241
2204	0	89	105	39	233
2205	0	73	93	28	194
2206	0	76	103	34	213
2207	0	80	99	26	205
2208	0	75	104	38	217
2209	0	77	111	32	220
2210	0	73	105	32	210
2211	0	75	87	28	190
2212	0	75	88	30	193
2213	0	64	83	33	180
2214	0	83	101	29	213
2215	0	93	112	30	235
2216	0	70	86	30	186
2217	0	84	117	28	229
2218	0	75	94	37	206
2219	0	71	82	25	178
2220	0	74	98	26	198
2221	0	84	85	29	198
2222	0	62	84	37	183
2223	0	87	106	39	232
2224	0	82	100	28	210
2225	0	69	89	28	186
2226	0	77	109	28	214
2227	0	78	88	42	208
2228	0	70	97	37	204
2229	0	78	107	29	214
2230	0	73	79	33	185
2231	0	85	106	32	223
2232	0	74	89	38	201
2233	0	72	101	30	203
2234	0	61	84	28	173
2235	0	93	83	29	205
2236	0	74	103	36	213
2237	0	73	82	30	185
2238	0	90	87	29	206
2239	0	84	110	25	219
2240	0	70	88	32	190
2241	0	74	88	26	188
2242	0	85	92	19	196
2243	0	71	84	36	191
2244	0	74	93	27	194
2245	0	98	89	35	222
2246	0	79	87	37	203
2247	0	68	106	42	216
2248	0	69	105	27	201
2249	0	89	95	30	214
2250	0	76	100	30	206
2251	0	83	88	37	208
2252	0	84	89	37	210
2253	0	64	93	33	190
2254	0	95	98	34	227
2255	0	77	109	29	215
2256	0	72	89	22	183
2257	0	89	84	25	198
2258	0	62	86	33	181
2259	0	70	89	31	190
2260	0	70	97	32	199
2261	0	75	109	24	208
2262	0	62	96	30	188
2263	0	88	86	30	204
2264	0	75	109	28	212
2265	0	73	80	26	179
2266	0	68	89	29	186
2267	0	72	106	44	222
2268	0	81	99	32	212
2269	0	58	107	16	181
2270	0	81	94	23	198
2271	0	61	82	26	169
2272	0	76	109	30	215
2273	0	58	110	28	196
2274	0	63	90	36	189
2275	0	61	84	29	174
2276	0	65	97	30	192
2277	0	80	81	29	190
2278	0	65	101	19	185
2279	0	76	90	36	202
2280	0	82	107	27	216
2281	0	80	96	39	215
2282	0	62	96	24	182
2283	0	89	99	27	215
2284	0	79	103	30	212
2285	0	89	71	25	185
2286	0	67	87	24	178
2287	0	77	115	29	221
2288	0	82	98	21	201
2289	0	73	84	36	193
2290	0	80	91	24	195
2291	0	75	97	32	204
2292	0	69	87	29	185
2293	0	77	96	32	205
2294	0	71	111	31	213
2295	0	63	88	37	188
2296	0	71	89	34	194
2297	0	71	91	39	201
2298	0	81	90	31	202
2299	0	64	83	33	180
2300	0	72	95	29	196
2301	0	73	102	27	202
2302	0	84	84	40	208
2303	0	79	99	39	217
2304	0	78	91	22	191
2305	0	68	103	28	199
2306	0	83	82	25	190
2307	0	71	96	23	190
2308	0	57	95	33	185
2309	0	69	93	30	192
2310	0	69	90	28	187
2311	0	63	73	22	158
2312	0	84	76	33	193
2313	0	68	85	30	183
2314	0	85	98	32	215
2315	0	78	97	19	194
2316	0	72	97	34	203
2317	0	77	82	21	180
2318	0	65	100	27	192
2319	0	49	87	37	173
2320	0	67	88	35	190
2321	0	76	92	43	211
2322	0	75	92	33	200
2323	0	62	104	31	197
2324	0	76	96	28	200
2325	0	65	80	27	172
2326	0	80	81	23	184
2327	0	73	108	23	204
2328	0	65	89	25	179
2329	0	68	98	25	191
2330	0	57	85	29	171
2331	0	74	87	35	196
2332	0	78	88	28	194
2333	0	67	91	35	193
2334	0	84	92	28	204
2335	0	61	76	29	166
2336	0	62	82	20	164
2337	0	71	94	32	197
2338	0	64	89	25	178
2339	0	78	86	26	190
2340	0	70	94	25	189
2341	0	66	86	24	176
2342	0	66	90	33	189
2343	0	75	91	28	194
2344	0	62	88	33	183
2345	0	69	106	27	202
2346	0	64	82	20	166
2347	0	72	96	31	199
2348	0	84	88	36	208
2349	0	70	96	30	196
2350	0	60	81	25	166
2351	0	67	82	28	177
2352	0	68	81	22	171
2353	0	75	79	31	185
2354	0	63	76	27	166
2355	0	57	80	27	164
2356	0	77	62	35	174
2357	0	67	85	24	176
2358	0	74	79	22	175
2359	0	78	95	35	208
2360	0	60	88	27	175
2361	0	68	97	43	208
2362	0	72	84	38	194
2363	0	61	80	19	160
2364	0	63	98	29	190
2365	0	55	99	30	184
2366	0	71	80	23	174
2367	0	62	73	38	173
2368	0	76	83	27	186
2369	0	63	86	24	173
2370	0	60	78	21	159
2371	0	60	87	27	174
2372	0	76	88	25	189
2373	0	61	93	32	186
2374	0	76	83	24	183
2375	0	75	96	24	195
2376	0	58	90	33	181
2377	0	67	105	34	206
2378	0	61	82	31	174
2379	0	64	76	29	169
2380	0	71	74	24	169
2381	0	62	87	38	187
2382	0	73	83	20	176
2383	0	67	88	36	191
2384	0	69	76	25	170
2385	0	67	118	33	218
2386	0	80	101	35	216
2387	0	68	91	24	183
2388	0	76	99	26	201
2389	0	68	90	30	188
2390	0	71	121	37	229
2391	0	58	133	34	225
2392	0	64	116	31	211
2393	0	61	110	26	197
2394	0	74	144	27	245
2395	0	77	299	20	396
2396	0	68	133	26	227
2397	0	65	110	25	200
2398	0	82	129	31	242
2399	0	53	281	27	361
2400	0	75	99	32	206
2401	0	62	103	24	189
2402	0	79	105	33	217
2403	0	73	107	23	203
2404	0	63	77	22	162
2405	0	59	81	23	163
2406	0	90	81	34	205
2407	0	66	84	19	169
2408	0	61	98	19	178
2409	0	74	77	24	175
2410	0	52	78	34	164
2411	0	64	83	31	178
2412	0	75	91	37	203
2413	0	55	82	25	162
2414	0	51	115	26	192
2415	0	65	84	28	177
2416	0	64	73	19	156
2417	0	71	69	39	179
2418	0	64	67	26	157
2419	0	75	77	22	174
2420	0	60	92	25	177
2421	0	47	68	25	140
2422	0	68	84	25	177
2423	0	56	95	29	180
2424	0	68	83	39	190
2425	0	63	76	21	160
2426	0	63	86	32	181
2427	0	77	81	35	193
2428	0	61	87	19	167
2429	0	77	69	16	162
2430	0	68	83	40	191
2431	0	64	89	33	186
2432	0	61	80	37	178
2433	0	65	79	23	167
2434	0	59	91	30	180
2435	0	52	82	22	156
2436	0	67	80	28	175
2437	0	67	77	18	162
2438	0	53	83	30	166
2439	0	51	60	35	146
2440	0	65	91	29	185
2441	0	57	86	34	177
2442	0	71	76	22	169
2443	0	62	82	32	176
2444	0	49	89	25	163
2445	0	53	78	34	165
2446	0	65	79	24	168
2447	0	56	82	26	164
2448	0	58	92	27	177
2449	0	60	93	27	180
2450	0	50	85	23	158
2451	0	62	69	33	164
2452	0	56	88	29	173
2453	0	53	82	19	154
2454	0	61	80	29	170
2455	0	68	83	28	179
2456	0	69	89	24	182
2457	0	70	79	23	172
2458	0	61	86	23	170
2459	0	76	80	24	180
2460	0	82	81	27	190
2461	0	80	79	33	192
2462	0	68	85	23	176
2463	0	59	98	25	182
2464	0	64	78	25	167
2465	0	62	89	20	171
2466	0	43	77	20	140
2467	0	64	88	26	178
2468	0	54	66	41	161
2469	0	81	66	15	162
2470	0	57	89	24	170
2471	0	64	78	30	172
2472	0	74	83	26	183
2473	0	64	73	25	162
2474	0	58	75	29	162
2475	0	63	74	28	165
2476	0	62	81	31	174
2477	0	57	72	28	157
2478	0	63	77	27	167
2479	0	57	75	30	162
2480	0	60	75	25	160
2481	0	58	83	21	162
2482	0	66	76	26	168
2483	0	61	82	25	168
2484	0	62	80	20	162
2485	0	62	78	28	168
2486	0	61	79	25	165
2487	0	67	80	34	181
2488	0	59	80	27	166
2489	0	65	94	26	185
2490	0	70	93	24	187
2491	0	42	87	27	156
2492	0	60	64	21	145
2493	0	64	62	28	154
2494	0	57	67	28	152
2495	0	64	68	39	171
2496	0	58	76	25	159
2497	0	60	62	37	159
2498	0	53	76	29	158
2499	0	71	99	31	201
2500	0	62	70	38	170
2501	0	64	80	20	164
2502	0	54	97	25	176
2503	0	63	90	20	173
2504	0	67	84	32	183
2505	0	57	83	25	165
2506	0	52	72	21	145
2507	0	59	73	24	156
2508	0	58	85	25	168
2509	0	69	71	22	162
2510	0	54	76	27	157
2511	0	59	76	19	154
2512	0	59	77	27	163
2513	0	69	78	20	167
2514	0	54	81	25	160
2515	0	59	64	28	151
2516	0	42	78	29	149
2517	0	51	64	18	133
2518	0	70	82	31	183
2519	0	57	84	28	169
2520	0	59	91	19	169
2521	0	70	78	26	174
2522	0	71	71	20	162
2523	0	71	97	27	195
2524	0	69	67	21	157
2525	0	61	83	20	164
2526	0	74	80	19	173
2527	0	68	87	19	174
2528	0	64	87	24	175
2529	0	51	78	21	150
2530	0	61	71	20	152
2531	0	74	75	21	170
2532	0	70	67	29	166
2533	0	52	83	28	163
2534	0	52	92	16	160
2535	0	54	71	25	150
2536	0	57	71	23	151
2537	0	48	78	24	150
2538	0	61	76	22	159
2539	0	60	73	23	156
2540	0	41	60	26	127
2541	0	59	74	19	152
2542	0	67	74	16	157
2543	0	57	66	37	160
2544	0	57	67	25	149
2545	0	60	78	17	155
2546	0	47	69	24	140
2547	0	59	87	26	172
2548	0	68	82	22	172
2549	0	60	80	27	167
2550	0	63	62	28	153
2551	0	68	76	37	181
2552	0	70	73	33	176
2553	0	42	83	25	150
2554	0	59	83	23	165
2555	0	56	73	18	147
2556	0	65	70	26	161
2557	0	65	71	23	159
2558	0	56	76	25	157
2559	0	65	86	31	182
2560	0	52	85	18	155
2561	0	52	75	35	162
2562	0	45	78	28	151
2563	0	59	78	29	166
2564	0	58	91	19	168
2565	0	62	71	23	156
2566	0	68	86	21	175
2567	0	51	83	26	160
2568	0	56	79	27	162
2569	0	61	71	21	153
2570	0	58	86	33	177
2571	0	58	70	22	150
2572	0	66	71	17	154
2573	0	45	77	31	153
2574	0	76	85	24	185
2575	0	58	73	22	153
2576	0	60	71	21	152
2577	0	58	78	23	159
2578	0	58	75	26	159
2579	0	68	77	24	169
2580	0	59	77	25	161
2581	0	59	68	26	153
2582	0	52	71	30	153
2583	0	53	85	30	168
2584	0	66	93	22	181
2585	0	52	73	19	144
2586	0	44	84	28	156
2587	0	66	71	14	151
2588	0	70	89	24	183
2589	0	56	84	31	171
2590	0	63	90	18	171
2591	0	49	84	25	158
2592	0	49	57	30	136
2593	0	61	79	33	173
2594	0	52	77	29	158
2595	0	60	84	17	161
2596	0	50	85	21	156
2597	0	58	73	30	161
2598	0	41	81	23	145
2599	0	55	87	31	173
2600	0	54	82	23	159
2601	0	59	83	24	166
2602	0	58	69	26	153
2603	0	58	81	22	161
2604	0	67	70	26	163
2605	0	46	83	25	154
2606	0	52	48	37	137
2607	0	64	70	22	156
2608	0	69	80	34	183
2609	0	59	77	22	158
2610	0	58	59	21	138
2611	0	53	66	23	142
2612	0	52	73	27	152
2613	0	52	80	15	147
2614	0	55	73	24	152
2615	0	68	74	28	170
2616	0	69	68	19	156
2617	0	50	68	25	143
2618	0	48	60	26	134
2619	0	47	76	23	146
2620	0	58	85	25	168
2621	0	50	69	30	149
2622	0	42	65	27	134
2623	0	64	65	18	147
2624	0	53	68	20	141
2625	0	51	76	25	152
2626	0	66	65	23	154
2627	0	60	63	28	151
2628	0	51	73	33	157
2629	0	63	88	20	171
2630	0	65	57	19	141
2631	0	53	72	32	157
2632	0	53	65	26	144
2633	0	55	75	21	151
2634	0	60	70	23	153
2635	0	54	76	16	146
2636	0	50	75	25	150
2637	0	57	65	17	139
2638	0	59	58	19	136
2639	0	54	66	16	136
2640	0	56	60	25	141
2641	0	62	91	24	177
2642	0	57	70	26	153
2643	0	40	70	18	128
2644	0	55	70	17	142
2645	0	55	81	16	152
2646	0	45	66	26	137
2647	0	51	70	23	144
2648	0	53	71	26	150
2649	0	56	78	23	157
2650	0	54	77	19	150
2651	0	49	77	14	140
2652	0	46	63	27	136
2653	0	58	69	24	151
2654	0	64	59	28	151
2655	0	65	88	27	180
2656	0	48	87	25	160
2657	0	61	72	20	153
2658	0	72	69	21	162
2659	0	58	66	28	152
2660	0	59	62	21	142
2661	0	68	64	21	153
2662	0	60	72	23	155
2663	0	58	71	23	152
2664	0	53	88	29	170
2665	0	67	73	28	168
2666	0	60	73	20	153
2667	0	56	61	21	138
2668	0	62	77	21	160
2669	0	51	65	25	141
2670	0	50	67	26	143
2671	0	58	64	19	141
2672	0	53	69	29	151
2673	0	59	67	28	154
2674	0	46	85	19	150
2675	0	69	68	21	158
2676	0	64	68	31	163
2677	0	60	88	24	172
2678	0	51	68	19	138
2679	0	54	66	21	141
2680	0	53	68	20	141
2681	0	49	65	19	133
2682	0	55	67	25	147
2683	0	43	71	27	141
2684	0	53	78	24	155
2685	0	51	54	29	134
2686	0	52	77	20	149
2687	0	61	64	24	149
2688	0	44	60	18	122
2689	0	57	64	22	143
2690	0	54	63	32	149
2691	0	51	80	16	147
2692	0	67	78	25	170
2693	0	61	73	27	161
2694	0	57	71	29	157
2695	0	66	66	16	148
2696	0	55	59	18	132
2697	0	66	82	23	171
2698	0	68	75	20	163
2699	0	50	60	21	131
2700	0	50	74	29	153
2701	0	46	83	25	154
2702	0	47	79	20	146
2703	0	65	70	32	167
2704	0	41	83	24	148
2705	0	63	71	18	152
2706	0	60	72	15	147
2707	0	64	70	17	151
2708	0	56	63	24	143
2709	0	51	64	31	146
2710	0	58	84	28	170
2711	0	52	72	21	145
2712	0	53	71	27	151
2713	0	53	65	22	140
2714	0	40	51	29	120
2715	0	59	76	28	163
2716	0	61	76	24	161
2717	0	46	60	23	129
2718	0	50	64	22	136
2719	0	38	81	24	143
2720	0	61	80	26	167
2721	0	51	53	26	130
2722	0	51	67	23	141
2723	0	59	62	19	140
2724	0	52	60	17	129
2725	0	56	63	21	140
2726	0	51	82	17	150
2727	0	60	73	26	159
2728	0	69	56	19	144
2729	0	43	68	14	125
2730	0	54	50	22	126
2731	0	61	75	20	156
2732	0	49	69	16	134
2733	0	49	70	30	149
2734	0	55	57	15	127
2735	0	55	78	27	160
2736	0	65	75	25	165
2737	0	47	81	19	147
2738	0	38	59	20	117
2739	0	53	66	25	144
2740	0	48	71	17	136
2741	0	42	85	22	149
2742	0	48	65	23	136
2743	0	49	56	13	118
2744	0	51	70	26	147
2745	0	49	66	27	142
2746	0	57	79	21	157
2747	0	53	75	17	145
2748	0	51	60	12	123
2749	0	46	73	12	131
2750	0	42	71	20	133
2751	0	56	66	23	145
2752	0	50	68	15	133
2753	0	55	57	23	135
2754	0	46	64	28	138
2755	0	53	62	27	142
2756	0	56	59	21	136
2757	0	53	58	23	134
2758	0	52	62	21	135
2759	0	52	65	23	140
2760	0	59	73	24	156
2761	0	60	60	21	141
2762	0	70	50	26	146
2763	0	56	68	20	144
2764	0	58	65	21	144
2765	0	66	62	22	150
2766	0	57	76	18	151
2767	0	46	73	23	142
2768	0	39	67	19	125
2769	0	58	55	17	130
2770	0	50	53	18	121
2771	0	35	78	13	126
2772	0	52	65	22	139
2773	0	53	68	15	136
2774	0	58	61	24	143
2775	0	65	67	19	151
2776	0	47	63	25	135
2777	0	50	73	12	135
2778	0	53	57	20	130
2779	0	41	64	17	122
2780	0	52	63	28	143
2781	0	60	57	19	136
2782	0	55	60	21	136
2783	0	50	56	20	126
2784	0	55	58	17	130
2785	0	50	61	18	129
2786	0	45	74	19	138
2787	0	57	57	33	147
2788	0	44	64	23	131
2789	0	58	52	19	129
2790	0	43	60	16	119
2791	0	44	65	22	131
2792	0	29	60	18	107
2793	0	51	63	24	138
2794	0	47	62	25	134
2795	0	51	58	22	131
2796	0	49	68	29	146
2797	0	47	60	21	128
2798	0	46	68	16	130
2799	0	40	64	27	131
2800	0	48	50	26	124
2801	0	48	62	31	141
2802	0	59	60	22	141
2803	0	47	52	20	119
2804	0	54	62	25	141
2805	0	32	51	20	103
2806	0	43	59	16	118
2807	0	51	57	23	131
2808	0	46	63	28	137
2809	0	58	55	20	133
2810	0	58	60	20	138
2811	0	46	72	22	140
2812	0	42	61	18	121
2813	0	49	72	25	146
2814	0	54	65	22	141
2815	0	53	70	22	145
2816	0	52	56	22	130
2817	0	44	51	23	118
2818	0	45	89	13	147
2819	0	49	62	20	131
2820	0	45	67	23	135
2821	0	42	69	16	127
2822	0	40	64	19	123
2823	0	52	77	17	146
2824	0	66	62	18	146
2825	0	58	54	17	129
2826	0	44	71	22	137
2827	0	53	56	26	135
2828	0	47	72	19	138
2829	0	42	72	17	131
2830	0	60	62	23	145
2831	0	57	73	25	155
2832	0	33	66	24	123
2833	0	45	66	23	134
2834	0	47	57	21	125
2835	0	49	73	15	137
2836	0	52	55	19	126
2837	0	39	64	25	128
2838	0	56	64	17	137
2839	0	59	69	21	149
2840	0	45	63	18	126
2841	0	55	51	22	128
2842	0	45	65	11	121
2843	0	42	57	21	120
2844	0	50	57	9	116
2845	0	54	53	11	118
2846	0	62	73	21	156
2847	0	43	70	17	130
2848	0	68	54	15	137
2849	0	53	55	15	123
2850	0	64	60	13	137
2851	0	55	53	20	128
2852	0	43	54	16	113
2853	0	50	60	19	129
2854	0	51	53	19	123
2855	0	42	62	14	118
2856	0	53	57	24	134
2857	0	38	78	22	138
2858	0	39	53	24	116
2859	0	51	54	27	132
2860	0	36	67	24	127
2861	0	36	60	27	123
2862	0	52	65	24	141
2863	0	49	40	23	112
2864	0	49	72	21	142
2865	0	51	53	22	126
2866	0	57	36	18	111
2867	0	40	51	20	111
2868	0	49	60	19	128
2869	0	51	57	19	127
2870	0	56	61	32	149
2871	0	49	54	17	120
2872	0	49	59	20	128
2873	0	38	55	20	113
2874	0	45	53	19	117
2875	0	44	52	24	120
2876	0	50	79	25	154
2877	0	40	63	17	120
2878	0	40	70	19	129
2879	0	37	62	22	121
2880	0	47	67	22	136
2881	0	37	60	21	118
2882	0	31	59	24	114
2883	0	52	72	14	138
2884	0	58	69	19	146
2885	0	47	50	17	114
2886	0	54	55	22	131
2887	0	46	69	12	127
2888	0	53	50	23	126
2889	0	48	72	16	136
2890	0	43	59	17	119
2891	0	38	62	22	122
2892	0	47	56	16	119
2893	0	49	60	19	128
2894	0	52	73	30	155
2895	0	54	71	23	148
2896	0	57	69	15	141
2897	0	56	54	28	138
2898	0	55	80	23	158
2899	0	65	56	17	138
2900	0	40	57	19	116
2901	0	46	52	15	113
2902	0	39	62	15	116
2903	0	50	81	18	149
2904	0	46	55	26	127
2905	0	58	56	19	133
2906	0	47	50	22	119
2907	0	47	67	22	136
2908	0	50	55	21	126
2909	0	43	56	20	119
2910	0	43	64	13	120
2911	0	50	57	17	124
2912	0	51	72	21	144
2913	0	48	60	19	127
2914	0	38	55	17	110
2915	0	37	52	13	102
2916	0	35	61	15	111
2917	0	61	45	18	124
2918	0	59	60	18	137
2919	0	47	57	18	122
2920	0	50	60	16	126
2921	0	37	75	20	132
2922	0	56	54	13	123
2923	0	41	58	9	108
2924	0	47	61	17	125
2925	0	51	61	23	135
2926	0	46	52	16	114
2927	0	40	62	20	122
2928	0	47	54	15	116
2929	0	61	64	23	148
2930	0	47	63	12	122
2931	0	47	52	11	110
2932	0	39	56	23	118
2933	0	52	58	26	136
2934	0	60	52	19	131
2935	0	45	69	20	134
2936	0	50	58	25	133
2937	0	59	45	13	117
2938	0	46	55	18	119
2939	0	44	55	24	123
2940	0	39	73	14	126
2941	0	41	75	15	131
2942	0	40	64	21	125
2943	0	57	59	12	128
2944	0	44	55	15	114
2945	0	56	65	17	138
2946	0	41	70	17	128
2947	0	36	45	14	95
2948	0	44	62	22	128
2949	0	35	65	24	124
2950	0	57	53	20	130
2951	0	41	59	16	116
2952	0	37	63	14	114
2953	0	47	58	18	123
2954	0	28	70	19	117
2955	0	42	61	20	123
2956	0	41	37	18	96
2957	0	49	54	18	121
2958	0	46	66	22	134
2959	0	51	53	23	127
2960	0	44	69	21	134
2961	0	40	49	18	107
2962	0	44	75	18	137
2963	0	47	55	27	129
2964	0	44	65	26	135
2965	0	47	49	25	121
2966	0	41	50	27	118
2967	0	50	50	17	117
2968	0	41	54	20	115
2969	0	47	64	20	131
2970	0	41	58	22	121
2971	0	41	63	24	128
2972	0	44	50	17	111
2973	0	47	68	25	140
2974	0	51	64	19	134
2975	0	50	54	12	116
2976	0	38	58	19	115
2977	0	46	55	23	124
2978	0	45	57	27	129
2979	0	44	64	19	127
2980	0	41	53	23	117
2981	0	43	63	24	130
2982	0	43	60	25	128
2983	0	45	75	35	155
2984	0	46	58	16	120
2985	0	43	58	27	128
2986	0	54	66	19	139
2987	0	55	64	19	138
2988	0	43	51	11	105
2989	0	48	58	18	124
2990	0	47	53	19	119
2991	0	47	70	18	135
2992	0	42	60	14	116
2993	0	37	68	13	118
2994	0	56	56	24	136
2995	0	45	54	15	114
2996	0	42	46	19	107
2997	0	39	51	14	104
2998	0	42	53	15	110
2999	0	46	65	21	132
3000	0	57	64	12	133
3001	0	37	66	21	124
3002	0	41	47	15	103
3003	0	44	47	15	106
3004	0	40	37	17	94
3005	0	44	65	13	122
3006	0	48	61	26	135
3007	0	37	74	15	126
3008	0	37	54	16	107
3009	0	52	63	15	130
3010	0	50	49	10	109
3011	0	39	50	22	111
3012	0	49	60	22	131
3013	0	49	55	21	125
3014	0	54	67	12	133
3015	0	42	61	18	121
3016	0	54	54	15	123
3017	0	37	57	14	108
3018	0	45	61	15	121
3019	0	45	52	17	114
3020	0	40	55	21	116
3021	0	41	56	16	113
3022	0	40	45	16	101
3023	0	39	52	16	107
3024	0	48	64	19	131
3025	0	43	49	22	114
3026	0	41	53	22	116
3027	0	32	48	16	96
3028	0	45	59	15	119
3029	0	62	64	17	143
3030	0	38	58	21	117
3031	0	43	69	22	134
3032	0	51	58	17	126
3033	0	41	48	18	107
3034	0	59	52	21	132
3035	0	41	64	16	121
3036	0	42	54	19	115
3037	0	46	44	19	109
3038	0	48	44	13	105
3039	0	37	56	15	108
3040	0	39	53	22	114
3041	0	39	50	17	106
3042	0	57	48	11	116
3043	0	40	57	18	115
3044	0	51	42	17	110
3045	0	39	57	18	114
3046	0	55	44	19	118
3047	0	45	55	17	117
3048	0	43	53	16	112
3049	0	40	60	21	121
3050	0	36	46	14	96
3051	0	43	56	22	121
3052	0	23	52	22	97
3053	0	43	52	14	109
3054	0	47	44	23	114
3055	0	45	52	20	117
3056	0	33	55	19	107
3057	0	52	44	10	106
3058	0	61	67	15	143
3059	0	46	50	17	113
3060	0	45	63	14	122
3061	0	40	61	17	118
3062	0	43	62	14	119
3063	0	37	46	20	103
3064	0	55	48	14	117
3065	0	44	50	15	109
3066	0	40	47	22	109
3067	0	48	69	16	133
3068	0	38	58	22	118
3069	0	45	52	15	112
3070	0	58	45	15	118
3071	0	42	49	21	112
3072	0	37	55	17	109
3073	0	44	58	17	119
3074	0	36	35	23	94
3075	0	34	52	24	110
3076	0	48	51	13	112
3077	0	39	50	15	104
3078	0	40	47	18	105
3079	0	56	62	22	140
3080	0	64	49	8	121
3081	0	39	48	25	112
3082	0	30	58	20	108
3083	0	51	42	17	110
3084	0	37	52	13	102
3085	0	50	49	11	110
3086	0	41	46	16	103
3087	0	45	53	15	113
3088	0	41	57	20	118
3089	0	36	42	16	94
3090	0	34	55	13	102
3091	0	40	61	18	119
3092	0	40	68	17	125
3093	0	31	55	14	100
3094	0	34	51	24	109
3095	0	36	59	17	112
3096	0	46	53	23	122
3097	0	43	50	19	112
3098	0	32	59	18	109
3099	0	52	57	10	119
3100	0	43	52	13	108
3101	0	49	44	19	112
3102	0	44	47	20	111
3103	0	33	51	20	104
3104	0	46	68	11	125
3105	0	39	49	15	103
3106	0	40	44	6	90
3107	0	42	45	11	98
3108	0	37	48	16	101
3109	0	47	48	10	105
3110	0	50	42	20	112
3111	0	53	68	13	134
3112	0	38	50	20	108
3113	0	43	45	14	102
3114	0	48	57	19	124
3115	0	42	52	22	116
3116	0	50	54	21	125
3117	0	44	80	10	134
3118	0	39	54	20	113
3119	0	23	50	18	91
3120	0	39	51	20	110
3121	0	42	48	16	106
3122	0	35	56	12	103
3123	0	30	51	20	101
3124	0	48	54	21	123
3125	0	50	46	24	120
3126	0	51	58	12	121
3127	0	46	56	20	122
3128	0	37	42	17	96
3129	0	42	51	16	109
3130	0	39	50	13	102
3131	0	44	49	20	113
3132	0	49	62	9	120
3133	0	33	52	13	98
3134	0	43	38	23	104
3135	0	47	53	17	117
3136	0	34	48	11	93
3137	0	42	49	21	112
3138	0	29	55	15	99
3139	0	30	46	11	87
3140	0	45	51	17	113
3141	0	32	42	15	89
3142	0	41	41	16	98
3143	0	33	52	17	102
3144	0	38	54	21	113
3145	0	45	52	20	117
3146	0	45	41	26	112
3147	0	35	54	10	99
3148	0	48	52	12	112
3149	0	32	41	11	84
3150	0	44	45	6	95
3151	0	30	54	18	102
3152	0	36	65	18	119
3153	0	43	45	12	100
3154	0	54	52	21	127
3155	0	32	53	25	110
3156	0	42	39	23	104
3157	0	37	61	18	116
3158	0	46	52	15	113
3159	0	44	54	25	123
3160	0	46	60	19	125
3161	0	36	54	14	104
3162	0	54	45	14	113
3163	0	31	55	13	99
3164	0	31	58	15	104
3165	0	40	38	16	94
3166	0	37	49	14	100
3167	0	44	48	13	105
3168	0	29	51	18	98
3169	0	51	53	16	120
3170	0	41	39	13	93
3171	0	41	51	19	111
3172	0	34	42	19	95
3173	0	42	48	17	107
3174	0	44	39	17	100
3175	0	36	51	19	106
3176	0	36	39	18	93
3177	0	39	49	17	105
3178	0	41	44	11	96
3179	0	38	37	17	92
3180	0	39	57	18	114
3181	0	40	45	13	98
3182	0	40	75	24	139
3183	0	37	56	14	107
3184	0	44	46	15	105
3185	0	42	54	8	104
3186	0	32	58	19	109
3187	0	55	47	16	118
3188	0	39	54	18	111
3189	0	43	44	14	101
3190	0	32	58	21	111
3191	0	30	43	18	91
3192	0	32	56	15	103
3193	0	42	51	12	105
3194	0	40	44	15	99
3195	0	46	51	15	112
3196	0	40	49	19	108
3197	0	36	39	22	97
3198	0	41	41	14	96
3199	0	40	58	19	117
3200	0	38	49	14	101
3201	0	49	47	24	120
3202	0	51	49	22	122
3203	0	42	49	11	102
3204	0	34	50	11	95
3205	0	24	66	19	109
3206	0	26	43	18	87
3207	0	39	54	13	106
3208	0	47	49	23	119
3209	0	39	56	18	113
3210	0	54	68	25	147
3211	0	34	49	18	101
3212	0	35	46	16	97
3213	0	34	38	14	86
3214	0	45	50	20	115
3215	0	37	51	21	109
3216	0	31	44	13	88
3217	0	28	52	19	99
3218	0	39	45	12	96
3219	0	41	45	15	101
3220	0	35	53	10	98
3221	0	47	47	9	103
3222	0	37	49	10	96
3223	0	29	48	12	89
3224	0	40	50	19	109
3225	0	47	42	16	105
3226	0	30	57	13	100
3227	0	37	61	15	113
3228	0	38	51	17	106
3229	0	36	48	15	99
3230	0	34	43	11	88
3231	0	39	49	19	107
3232	0	40	49	24	113
3233	0	31	52	18	101
3234	0	32	53	7	92
3235	0	27	41	18	86
3236	0	29	56	20	105
3237	0	46	61	14	121
3238	0	44	47	15	106
3239	0	34	51	10	95
3240	0	34	57	17	108
3241	0	47	44	14	105
3242	0	40	52	18	110
3243	0	44	50	9	103
3244	0	37	51	17	105
3245	0	33	52	16	101
3246	0	40	46	14	100
3247	0	40	30	17	87
3248	0	37	47	15	99
3249	0	43	50	20	113
3250	0	36	43	21	100
3251	0	40	65	19	124
3252	0	38	48	23	109
3253	0	34	42	16	92
3254	0	35	47	13	95
3255	0	30	43	15	88
3256	0	36	40	12	88
3257	0	43	40	11	94
3258	0	31	58	15	104
3259	0	39	60	12	111
3260	0	42	41	17	100
3261	0	46	38	11	95
3262	0	40	52	16	108
3263	0	45	50	20	115
3264	0	37	58	20	115
3265	0	43	52	17	112
3266	0	43	57	14	114
3267	0	41	45	17	103
3268	0	35	37	14	86
3269	0	46	43	13	102
3270	0	34	55	16	105
3271	0	32	46	13	91
3272	0	28	40	15	83
3273	0	46	48	19	113
3274	0	43	54	15	112
3275	0	34	45	14	93
3276	0	38	52	18	108
3277	0	33	53	20	106
3278	0	35	54	14	103
3279	0	41	44	16	101
3280	0	38	47	13	98
3281	0	33	51	24	108
3282	0	38	44	17	99
3283	0	29	53	20	102
3284	0	34	42	19	95
3285	0	43	41	16	100
3286	0	42	42	18	102
3287	0	38	41	16	95
3288	0	34	55	17	106
3289	0	38	50	18	106
3290	0	32	48	14	94
3291	0	31	39	26	96
3292	0	37	42	12	91
3293	0	35	44	11	90
3294	0	39	45	19	103
3295	0	51	51	22	124
3296	0	30	52	13	95
3297	0	28	50	15	93
3298	0	34	47	14	95
3299	0	42	49	17	108
3300	0	45	49	18	112
3301	0	41	45	20	106
3302	0	38	51	10	99
3303	0	36	52	13	101
3304	0	26	42	9	77
3305	0	41	39	21	101
3306	0	33	39	16	88
3307	0	36	39	21	96
3308	0	33	51	18	102
3309	0	34	47	24	105
3310	0	30	58	13	101
3311	0	35	39	14	88
3312	0	37	44	15	96
3313	0	36	33	18	87
3314	0	33	53	17	103
3315	0	42	57	16	115
3316	0	34	41	19	94
3317	0	36	47	17	100
3318	0	36	49	10	95
3319	0	32	46	12	90
3320	0	23	44	14	81
3321	0	28	52	13	93
3322	0	35	53	10	98
3323	0	34	45	16	95
3324	0	39	56	11	106
3325	0	36	47	13	96
3326	0	34	48	14	96
3327	0	44	55	23	122
3328	0	26	47	15	88
3329	0	39	46	9	94
3330	0	34	43	20	97
3331	0	34	33	7	74
3332	0	33	43	12	88
3333	0	46	53	11	110
3334	0	29	51	14	94
3335	0	25	45	22	92
3336	0	32	45	7	84
3337	0	34	58	17	109
3338	0	43	55	11	109
3339	0	32	46	20	98
3340	0	36	44	16	96
3341	0	33	25	11	69
3342	0	33	41	11	85
3343	0	27	44	16	87
3344	0	41	45	12	98
3345	0	35	44	11	90
3346	0	34	64	14	112
3347	0	32	34	17	83
3348	0	38	47	20	105
3349	0	35	51	15	101
3350	0	32	44	13	89
3351	0	37	36	8	81
3352	0	23	33	16	72
3353	0	31	36	14	81
3354	0	37	36	18	91
3355	0	18	44	15	77
3356	0	35	51	14	100
3357	0	29	46	21	96
3358	0	37	33	19	89
3359	0	43	45	10	98
3360	0	36	43	14	93
3361	0	33	45	15	93
3362	0	31	50	12	93
3363	0	38	38	16	92
3364	0	42	54	15	111
3365	0	29	48	11	88
3366	0	32	46	13	91
3367	0	39	50	17	106
3368	0	48	48	12	108
3369	0	33	46	17	96
3370	0	41	47	16	104
3371	0	40	48	17	105
3372	0	39	49	15	103
3373	0	31	45	13	89
3374	0	40	35	8	83
3375	0	35	44	12	91
3376	0	24	46	14	84
3377	0	35	36	8	79
3378	0	27	32	15	74
3379	0	37	43	14	94
3380	0	33	35	11	79
3381	0	36	49	12	97
3382	0	32	50	11	93
3383	0	34	44	23	101
3384	0	41	46	10	97
3385	0	46	52	20	118
3386	0	34	56	21	111
3387	0	45	48	17	110
3388	0	41	40	15	96
3389	0	33	50	15	98
3390	0	40	49	19	108
3391	0	27	39	10	76
3392	0	41	52	12	105
3393	0	46	45	16	107
3394	0	43	50	15	108
3395	0	40	44	15	99
3396	0	37	43	5	85
3397	0	40	33	14	87
3398	0	29	39	15	83
3399	0	44	37	17	98
3400	0	28	43	17	88
3401	0	40	49	11	100
3402	0	41	46	16	103
3403	0	27	44	14	85
3404	0	21	57	13	91
3405	0	29	39	14	82
3406	0	38	46	11	95
3407	0	40	45	18	103
3408	0	33	35	16	84
3409	0	30	49	13	92
3410	0	34	39	18	91
3411	0	32	38	11	81
3412	0	36	42	13	91
3413	0	29	51	9	89
3414	0	38	34	17	89
3415	0	33	36	17	86
3416	0	27	47	13	87
3417	0	29	44	23	96
3418	0	33	37	17	87
3419	0	32	50	21	103
3420	0	34	48	11	93
3421	0	32	47	16	95
3422	0	31	43	15	89
3423	0	36	46	11	93
3424	0	37	46	16	99
3425	0	31	55	13	99
3426	0	26	45	13	84
3427	0	26	40	10	76
3428	0	37	42	10	89
3429	0	37	36	11	84
3430	0	45	37	13	95
3431	0	50	38	9	97
3432	0	37	45	10	92
3433	0	28	39	18	85
3434	0	31	56	14	101
3435	0	35	39	18	92
3436	0	29	42	13	84
3437	0	38	34	10	82
3438	0	46	49	12	107
3439	0	34	33	8	75
3440	0	37	33	10	80
3441	0	42	42	29	113
3442	0	29	43	16	88
3443	0	39	40	12	91
3444	0	28	46	12	86
3445	0	43	57	11	111
3446	0	42	44	12	98
3447	0	30	37	16	83
3448	0	35	47	13	95
3449	0	32	46	11	89
3450	0	35	52	19	106
3451	0	31	43	10	84
3452	0	27	44	11	82
3453	0	30	52	14	96
3454	0	33	44	17	94
3455	0	47	42	13	102
3456	0	34	48	13	95
3457	0	37	40	13	90
3458	0	40	41	11	92
3459	0	42	40	18	100
3460	0	27	40	13	80
3461	0	43	39	14	96
3462	0	35	47	13	95
3463	0	35	44	14	93
3464	0	31	48	11	90
3465	0	28	29	14	71
3466	0	28	45	13	86
3467	0	35	40	5	80
3468	0	29	44	15	88
3469	0	26	44	15	85
3470	0	31	39	16	86
3471	0	26	43	14	83
3472	0	34	36	16	86
3473	0	35	44	13	92
3474	0	28	34	8	70
3475	0	32	42	12	86
3476	0	31	48	15	94
3477	0	40	41	11	92
3478	0	33	42	15	90
3479	0	30	44	15	89
3480	0	39	47	16	102
3481	0	36	49	20	105
3482	0	31	38	16	85
3483	0	29	42	15	86
3484	0	39	29	13	81
3485	0	27	31	9	67
3486	0	37	45	14	96
3487	0	44	49	16	109
3488	0	28	34	19	81
3489	0	38	37	11	86
3490	0	29	47	16	92
3491	0	37	44	6	87
3492	0	34	41	7	82
3493	0	42	33	16	91
3494	0	36	46	6	88
3495	0	33	41	11	85
3496	0	44	49	9	102
3497	0	42	48	12	102
3498	0	33	45	15	93
3499	0	27	47	10	84
3500	0	31	51	10	92
3501	0	27	50	14	91
3502	0	41	42	18	101
3503	0	30	48	15	93
3504	0	36	39	13	88
3505	0	31	46	18	95
3506	0	33	58	12	103
3507	0	26	38	12	76
3508	0	39	49	7	95
3509	0	26	47	15	88
3510	0	28	38	15	81
3511	0	19	39	12	70
3512	0	39	46	14	99
3513	0	31	36	12	79
3514	0	32	44	13	89
3515	0	35	50	13	98
3516	0	40	35	17	92
3517	0	30	44	11	85
3518	0	29	40	13	82
3519	0	36	43	10	89
3520	0	36	53	17	106
3521	0	33	42	10	85
3522	0	26	39	19	84
3523	0	28	35	7	70
3524	0	33	50	12	95
3525	0	30	38	9	77
3526	0	26	39	17	82
3527	0	28	44	15	87
3528	0	31	46	6	83
3529	0	33	36	13	82
3530	0	27	45	18	90
3531	0	30	37	12	79
3532	0	32	33	14	79
3533	0	25	43	10	78
3534	0	37	33	16	86
3535	0	34	28	13	75
3536	0	54	35	12	101
3537	0	38	35	6	79
3538	0	34	35	16	85
3539	0	33	45	12	90
3540	0	32	43	9	84
3541	0	31	41	2	74
3542	0	42	42	11	95
3543	0	27	48	13	88
3544	0	29	41	7	77
3545	0	25	41	15	81
3546	0	28	32	11	71
3547	0	35	32	13	80
3548	0	25	36	5	66
3549	0	29	42	9	80
3550	0	38	38	15	91
3551	0	31	35	11	77
3552	0	38	32	11	81
3553	0	41	34	14	89
3554	0	23	35	11	69
3555	0	33	48	9	90
3556	0	30	45	14	89
3557	0	37	38	8	83
3558	0	31	36	13	80
3559	0	37	44	18	99
3560	0	37	38	12	87
3561	0	37	39	11	87
3562	0	31	23	20	74
3563	0	29	31	11	71
3564	0	40	40	12	92
3565	0	24	33	14	71
3566	0	33	42	13	88
3567	0	29	34	10	73
3568	0	18	34	11	63
3569	0	30	47	8	85
3570	0	25	48	13	86
3571	0	31	44	15	90
3572	0	26	42	17	85
3573	0	27	46	7	80
3574	0	27	38	7	72
3575	0	28	33	11	72
3576	0	36	39	11	86
3577	0	20	32	12	64
3578	0	26	25	12	63
3579	0	27	34	9	70
3580	0	30	26	12	68
3581	0	37	42	18	97
3582	0	40	37	14	91
3583	0	42	42	10	94
3584	0	36	48	12	96
3585	0	37	42	15	94
3586	0	29	41	10	80
3587	0	33	49	17	99
3588	0	32	31	10	73
3589	0	29	47	11	87
3590	0	34	38	9	81
3591	0	31	33	6	70
3592	0	33	44	5	82
3593	0	30	33	17	80
3594	0	36	38	12	86
3595	0	33	42	8	83
3596	0	25	41	7	73
3597	0	34	37	14	85
3598	0	42	34	15	91
3599	0	23	45	8	76
3600	0	30	41	10	81
3601	0	33	30	10	73
3602	0	25	29	10	64
3603	0	22	34	19	75
3604	0	31	29	14	74
3605	0	23	43	19	85
3606	0	29	35	12	76
3607	0	26	40	11	77
3608	0	40	26	13	79
3609	0	31	35	16	82
3610	0	33	37	10	80
3611	0	32	31	11	74
3612	0	26	31	9	66
3613	0	37	37	13	87
3614	0	37	33	5	75
3615	0	29	37	11	77
3616	0	38	41	11	90
3617	0	32	26	20	78
3618	0	37	35	13	85
3619	0	29	35	15	79
3620	0	25	45	6	76
3621	0	30	46	12	88
3622	0	28	51	13	92
3623	0	26	44	9	79
3624	0	30	43	7	80
3625	0	25	41	12	78
3626	0	34	47	17	98
3627	0	20	32	11	63
3628	0	31	30	9	70
3629	0	29	41	13	83
3630	0	34	40	17	91
3631	0	27	36	11	74
3632	0	36	39	13	88
3633	0	32	39	13	84
3634	0	22	28	15	65
3635	0	25	33	11	69
3636	0	27	40	15	82
3637	0	26	40	14	80
3638	0	26	49	8	83
3639	0	20	47	8	75
3640	0	33	33	13	79
3641	0	28	39	14	81
3642	0	37	38	10	85
3643	0	19	41	7	67
3644	0	28	40	14	82
3645	0	42	50	12	104
3646	0	27	41	8	76
3647	0	31	42	12	85
3648	0	30	43	11	84
3649	0	25	45	13	83
3650	0	29	41	9	79
3651	0	36	45	8	89
3652	0	32	43	13	88
3653	0	32	42	12	86
3654	0	31	48	10	89
3655	0	21	39	11	71
3656	0	28	53	12	93
3657	0	34	41	11	86
3658	0	34	33	18	85
3659	0	39	33	17	89
3660	0	38	48	12	98
3661	0	40	31	17	88
3662	0	35	34	13	82
3663	0	34	48	10	92
3664	0	28	39	10	77
3665	0	33	31	12	76
3666	0	25	35	12	72
3667	0	25	37	10	72
3668	0	37	39	12	88
3669	0	28	43	11	82
3670	0	23	41	13	77
3671	0	23	24	12	59
3672	0	35	44	15	94
3673	0	34	39	15	88
3674	0	32	29	10	71
3675	0	29	25	9	63
3676	0	24	40	8	72
3677	0	27	37	10	74
3678	0	17	35	8	60
3679	0	30	36	11	77
3680	0	20	38	13	71
3681	0	26	29	20	75
3682	0	25	36	11	72
3683	0	27	41	12	80
3684	0	28	41	11	80
3685	0	31	40	15	86
3686	0	27	31	12	70
3687	0	30	35	9	74
3688	0	23	40	14	77
3689	0	19	41	12	72
3690	0	39	42	8	89
3691	0	27	34	14	75
3692	0	28	40	21	89
3693	0	32	36	9	77
3694	0	31	36	6	73
3695	0	20	35	11	66
3696	0	36	36	8	80
3697	0	34	37	10	81
3698	0	26	40	9	75
3699	0	24	40	11	75
3700	0	31	39	9	79
3701	0	31	26	9	66
3702	0	24	40	13	77
3703	0	32	31	13	76
3704	0	32	28	11	71
3705	0	30	37	11	78
3706	0	37	41	13	91
3707	0	33	35	12	80
3708	0	37	34	14	85
3709	0	33	40	16	89
3710	0	28	47	10	85
3711	0	31	37	11	79
3712	0	23	36	11	70
3713	0	21	38	10	69
3714	0	37	35	10	82
3715	0	22	39	16	77
3716	0	33	36	13	82
3717	0	32	37	7	76
3718	0	32	35	11	78
3719	0	31	34	13	78
3720	0	23	31	9	63
3721	0	23	41	13	77
3722	0	27	49	8	84
3723	0	33	27	12	72
3724	0	34	40	12	86
3725	0	26	30	12	68
3726	0	20	27	8	55
3727	0	31	36	7	74
3728	0	32	31	12	75
3729	0	28	33	17	78
3730	0	37	36	17	90
3731	0	30	37	15	82
3732	0	27	26	9	62
3733	0	30	38	14	82
3734	0	17	35	12	64
3735	0	31	32	14	77
3736	0	24	33	11	68
3737	0	29	43	9	81
3738	0	31	30	10	71
3739	0	28	39	12	79
3740	0	19	19	10	48
3741	0	27	41	5	73
3742	0	33	38	12	83
3743	0	43	41	12	96
3744	0	22	31	14	67
3745	0	20	36	12	68
3746	0	25	43	12	80
3747	0	23	32	10	65
3748	0	21	31	11	63
3749	0	17	38	9	64
3750	0	25	33	16	74
3751	0	32	30	13	75
3752	0	30	28	9	67
3753	0	25	28	10	63
3754	0	28	37	10	75
3755	0	25	34	13	72
3756	0	34	47	17	98
3757	0	28	37	10	75
3758	0	32	42	4	78
3759	0	37	36	12	85
3760	0	25	28	13	66
3761	0	28	24	9	61
3762	0	20	36	5	61
3763	0	31	32	11	74
3764	0	20	35	9	64
3765	0	34	39	21	94
3766	0	31	34	8	73
3767	0	30	47	10	87
3768	0	21	31	12	64
3769	0	34	36	20	90
3770	0	28	38	8	74
3771	0	40	35	17	92
3772	0	28	32	9	69
3773	0	28	41	15	84
3774	0	32	43	12	87
3775	0	32	44	11	87
3776	0	31	36	10	77
3777	0	24	25	7	56
3778	0	30	30	10	70
3779	0	23	31	4	58
3780	0	32	30	13	75
3781	0	29	43	8	80
3782	0	19	35	9	63
3783	0	35	36	12	83
3784	0	29	35	9	73
3785	0	30	30	10	70
3786	0	27	34	9	70
3787	0	28	29	13	70
3788	0	37	33	14	84
3789	0	21	31	9	61
3790	0	25	34	10	69
3791	0	34	33	13	80
3792	0	22	27	10	59
3793	0	33	32	14	79
3794	0	23	32	12	67
3795	0	29	39	12	80
3796	0	26	30	12	68
3797	0	23	36	15	74
3798	0	25	34	8	67
3799	0	35	38	10	83
3800	0	25	29	14	68
3801	0	34	35	10	79
3802	0	21	54	18	93
3803	0	30	28	14	72
3804	0	36	30	17	83
3805	0	33	36	10	79
3806	0	28	43	11	82
3807	0	32	41	14	87
3808	0	25	27	16	68
3809	0	38	21	14	73
3810	0	25	30	9	64
3811	0	21	29	12	62
3812	0	23	29	10	62
3813	0	30	35	12	77
3814	0	31	30	8	69
3815	0	18	37	9	64
3816	0	37	32	9	78
3817	0	31	28	16	75
3818	0	31	27	13	71
3819	0	29	44	14	87
3820	0	29	31	13	73
3821	0	29	34	9	72
3822	0	33	31	16	80
3823	0	24	40	17	81
3824	0	21	32	9	62
3825	0	34	30	12	76
3826	0	22	34	13	69
3827	0	21	40	16	77
3828	0	24	29	13	66
3829	0	21	33	20	74
3830	0	33	35	9	77
3831	0	28	29	9	66
3832	0	36	24	11	71
3833	0	22	26	13	61
3834	0	26	29	8	63
3835	0	28	39	9	76
3836	0	24	34	11	69
3837	0	23	33	15	71
3838	0	20	40	6	66
3839	0	34	39	12	85
3840	0	28	38	6	72
3841	0	25	45	13	83
3842	0	21	39	12	72
3843	0	30	27	5	62
3844	0	22	36	10	68
3845	0	29	49	8	86
3846	0	29	33	10	72
3847	0	32	28	15	75
3848	0	26	29	16	71
3849	0	21	33	13	67
3850	0	28	37	16	81
3851	0	30	29	12	71
3852	0	27	27	11	65
3853	0	36	38	9	83
3854	0	28	40	8	76
3855	0	34	42	13	89
3856	0	28	32	12	72
3857	0	38	26	12	76
3858	0	20	37	5	62
3859	0	26	26	15	67
3860	0	18	48	12	78
3861	0	20	39	13	72
3862	0	25	27	9	61
3863	0	22	41	4	67
3864	0	36	29	6	71
3865	0	22	42	14	78
3866	0	25	28	9	62
3867	0	33	36	17	86
3868	0	28	36	8	72
3869	0	26	28	7	61
3870	0	33	39	9	81
3871	0	15	27	11	53
3872	0	22	35	8	65
3873	0	28	31	11	70
3874	0	42	36	9	87
3875	0	29	35	6	70
3876	0	30	30	7	67
3877	0	30	36	14	80
3878	0	34	33	12	79
3879	0	25	36	5	66
3880	0	22	38	10	70
3881	0	31	30	11	72
3882	0	39	28	6	73
3883	0	29	29	13	71
3884	0	30	39	14	83
3885	0	18	29	10	57
3886	0	28	31	13	72
3887	0	22	42	16	80
3888	0	23	34	8	65
3889	0	29	34	5	68
3890	0	22	31	11	64
3891	0	23	34	14	71
3892	0	28	32	10	70
3893	0	32	29	14	75
3894	0	28	34	16	78
3895	0	19	24	10	53
3896	0	18	32	15	65
3897	0	32	36	10	78
3898	0	23	52	9	84
3899	0	23	33	10	66
3900	0	33	23	13	69
3901	0	27	29	12	68
3902	0	21	43	9	73
3903	0	28	26	11	65
3904	0	22	29	13	64
3905	0	15	33	9	57
3906	0	24	25	12	61
3907	0	20	34	5	59
3908	0	33	27	13	73
3909	0	22	30	16	68
3910	0	23	31	10	64
3911	0	22	30	8	60
3912	0	18	46	10	74
3913	0	26	38	6	70
3914	0	27	29	9	65
3915	0	23	30	8	61
3916	0	32	39	11	82
3917	0	25	29	8	62
3918	0	23	29	6	58
3919	0	30	30	17	77
3920	0	38	26	9	73
3921	0	23	32	9	64
3922	0	25	34	10	69
3923	0	13	46	11	70
3924	0	19	32	15	66
3925	0	31	22	7	60
3926	0	22	33	11	66
3927	0	33	33	12	78
3928	0	33	31	4	68
3929	0	22	34	4	60
3930	0	23	38	7	68
3931	0	28	43	8	79
3932	0	23	29	4	56
3933	0	27	39	11	77
3934	0	28	35	8	71
3935	0	25	30	10	65
3936	0	25	29	10	64
3937	0	26	42	15	83
3938	0	19	32	7	58
3939	0	20	28	7	55
3940	0	30	27	8	65
3941	0	38	35	12	85
3942	0	24	37	14	75
3943	0	34	29	11	74
3944	0	35	31	7	73
3945	0	29	42	10	81
3946	0	16	47	18	81
3947	0	22	32	11	65
3948	0	30	28	10	68
3949	0	28	30	14	72
3950	0	31	35	10	76
3951	0	31	26	13	70
3952	0	38	34	8	80
3953	0	25	32	13	70
3954	0	32	37	6	75
3955	0	27	28	12	67
3956	0	33	29	13	75
3957	0	32	24	13	69
3958	0	29	26	11	66
3959	0	25	32	12	69
3960	0	26	36	7	69
3961	0	22	29	13	64
3962	0	31	29	8	68
3963	0	34	33	7	74
3964	0	34	31	18	83
3965	0	37	32	10	79
3966	0	22	41	11	74
3967	0	51	36	14	101
3968	0	37	27	11	75
3969	0	30	25	6	61
3970	0	36	29	8	73
3971	0	29	30	9	68
3972	0	33	27	11	71
3973	0	26	27	13	66
3974	0	25	28	8	61
3975	0	31	35	6	72
3976	0	19	32	13	64
3977	0	30	29	13	72
3978	0	28	30	5	63
3979	0	26	34	10	70
3980	0	24	35	14	73
3981	0	23	29	8	60
3982	0	36	49	17	102
3983	0	21	39	8	68
3984	0	25	29	9	63
3985	0	34	26	5	65
3986	0	25	35	6	66
3987	0	18	30	12	60
3988	0	22	35	10	67
3989	0	28	34	9	71
3990	0	31	35	11	77
3991	0	23	27	15	65
3992	0	26	30	16	72
3993	0	26	37	8	71
3994	0	30	29	10	69
3995	0	21	29	11	61
3996	0	25	38	10	73
3997	0	24	30	10	64
3998	0	19	25	17	61
3999	0	23	34	12	69
4000	0	27	29	10	66
4001	0	24	26	12	62
4002	0	25	32	14	71
4003	0	24	24	13	61
4004	0	32	35	9	76
4005	0	20	26	14	60
4006	0	28	30	13	71
4007	0	22	35	11	68
4008	0	26	32	14	72
4009	0	18	28	5	51
4010	0	27	28	16	71
4011	0	28	35	8	71
4012	0	21	17	14	52
4013	0	33	25	16	74
4014	0	27	25	14	66
4015	0	31	27	11	69
4016	0	23	24	13	60
4017	0	29	41	14	84
4018	0	25	36	7	68
4019	0	26	39	16	81
4020	0	23	17	17	57
4021	0	30	26	11	67
4022	0	26	29	11	66
4023	0	26	23	13	62
4024	0	18	27	9	54
4025	0	24	29	12	65
4026	0	21	28	13	62
4027	0	27	21	13	61
4028	0	32	25	7	64
4029	0	20	43	10	73
4030	0	21	17	10	48
4031	0	31	26	11	68
4032	0	20	35	11	66
4033	0	37	33	7	77
4034	0	21	33	9	63
4035	0	25	37	4	66
4036	0	32	32	7	71
4037	0	31	42	14	87
4038	0	18	21	9	48
4039	0	27	33	13	73
4040	0	18	41	6	65
4041	0	29	39	9	77
4042	0	22	34	11	67
4043	0	29	29	10	68
4044	0	26	35	8	69
4045	0	19	36	13	68
4046	0	22	47	12	81
4047	0	26	53	10	89
4048	0	24	45	9	78
4049	0	25	54	10	89
4050	0	29	48	9	86
4051	0	20	62	9	91
4052	0	37	76	9	122
4053	0	20	58	8	86
4054	0	22	46	11	79
4055	0	21	53	14	88
4056	0	22	77	6	105
4057	0	17	52	8	77
4058	0	27	28	5	60
4059	0	29	31	8	68
4060	0	18	28	9	55
4061	0	31	38	10	79
4062	0	28	21	8	57
4063	0	23	28	7	58
4064	0	32	36	13	81
4065	0	22	34	9	65
4066	0	19	27	8	54
4067	0	18	36	9	63
4068	0	34	33	8	75
4069	0	31	25	10	66
4070	0	26	26	9	61
4071	0	23	42	11	76
4072	0	30	30	19	79
4073	0	16	32	16	64
4074	0	19	27	15	61
4075	0	16	32	9	57
4076	0	23	22	22	67
4077	0	27	24	23	74
4078	0	18	29	15	62
4079	0	24	33	9	66
4080	0	25	33	12	70
4081	0	24	28	13	65
4082	0	25	30	6	61
4083	0	26	33	13	72
4084	0	27	34	15	76
4085	0	24	24	8	56
4086	0	23	23	13	59
4087	0	18	29	10	57
4088	0	24	27	8	59
4089	0	19	36	12	67
4090	0	26	30	13	69
4091	0	21	20	14	55
4092	0	26	33	11	70
4093	0	34	24	5	63
4094	0	20	31	13	64
4095	0	20	33	11	64
4096	0	27	31	9	67
4097	0	22	33	7	62
4098	0	19	23	6	48
4099	0	29	38	6	73
4100	0	32	30	10	72
4101	0	25	31	8	64
4102	0	21	29	8	58
4103	0	24	33	12	69
4104	0	20	28	5	53
4105	0	20	33	9	62
4106	0	25	31	6	62
4107	0	22	33	18	73
4108	0	29	22	7	58
4109	0	16	27	6	49
4110	0	23	36	11	70
4111	0	15	35	9	59
4112	0	22	33	6	61
4113	0	27	20	8	55
4114	0	27	33	7	67
4115	0	20	34	13	67
4116	0	23	37	9	69
4117	0	28	24	8	60
4118	0	23	31	10	64
4119	0	23	32	7	62
4120	0	24	33	9	66
4121	0	30	31	11	72
4122	0	17	33	4	54
4123	0	27	29	9	65
4124	0	24	27	5	56
4125	0	25	35	10	70
4126	0	23	35	6	64
4127	0	18	32	10	60
4128	0	22	28	7	57
4129	0	29	31	3	63
4130	0	27	14	5	46
4131	0	22	18	6	46
4132	0	29	32	12	73
4133	0	20	30	6	56
4134	0	29	26	8	63
4135	0	24	36	7	67
4136	0	21	28	6	55
4137	0	20	22	12	54
4138	0	19	29	6	54
4139	0	24	32	7	63
4140	0	21	38	5	64
4141	0	22	33	8	63
4142	0	23	31	9	63
4143	0	22	28	14	64
4144	0	18	29	12	59
4145	0	24	33	7	64
4146	0	35	30	6	71
4147	0	24	37	10	71
4148	0	21	28	13	62
4149	0	21	28	8	57
4150	0	25	26	10	61
4151	0	16	32	4	52
4152	0	19	23	12	54
4153	0	25	28	9	62
4154	0	23	26	8	57
4155	0	21	29	9	59
4156	0	23	25	8	56
4157	0	21	26	13	60
4158	0	22	34	11	67
4159	0	27	29	4	60
4160	0	19	31	7	57
4161	0	25	28	12	65
4162	0	24	23	14	61
4163	0	31	31	5	67
4164	0	16	35	11	62
4165	0	22	27	7	56
4166	0	23	29	11	63
4167	0	11	21	7	39
4168	0	18	32	11	61
4169	0	26	29	8	63
4170	0	23	24	11	58
4171	0	19	30	11	60
4172	0	28	18	10	56
4173	0	22	22	7	51
4174	0	25	27	9	61
4175	0	31	27	12	70
4176	0	21	28	7	56
4177	0	29	29	16	74
4178	0	23	27	12	62
4179	0	16	28	14	58
4180	0	25	18	7	50
4181	0	20	24	8	52
4182	0	24	20	3	47
4183	0	17	23	10	50
4184	0	21	29	7	57
4185	0	33	31	9	73
4186	0	24	27	9	60
4187	0	35	28	8	71
4188	0	28	31	16	75
4189	0	15	33	9	57
4190	0	20	31	10	61
4191	0	28	28	7	63
4192	0	23	30	11	64
4193	0	19	32	10	61
4194	0	24	23	6	53
4195	0	16	33	8	57
4196	0	29	27	5	61
4197	0	14	21	7	42
4198	0	19	23	11	53
4199	0	26	21	14	61
4200	0	19	35	7	61
4201	0	22	23	10	55
4202	0	22	32	5	59
4203	0	20	43	12	75
4204	0	25	28	11	64
4205	0	21	24	10	55
4206	0	27	29	4	60
4207	0	17	34	8	59
4208	0	24	27	10	61
4209	0	9	31	5	45
4210	0	19	16	4	39
4211	0	27	24	10	61
4212	0	19	31	8	58
4213	0	19	28	8	55
4214	0	24	35	9	68
4215	0	23	28	5	56
4216	0	25	30	8	63
4217	0	26	32	10	68
4218	0	22	31	12	65
4219	0	19	21	10	50
4220	0	31	27	11	69
4221	0	26	36	10	72
4222	0	13	27	10	50
4223	0	32	27	7	66
4224	0	23	24	11	58
4225	0	28	39	9	76
4226	0	28	26	7	61
4227	0	21	33	8	62
4228	0	19	25	3	47
4229	0	16	31	16	63
4230	0	20	24	8	52
4231	0	25	24	13	62
4232	0	25	29	10	64
4233	0	31	22	13	66
4234	0	23	24	9	56
4235	0	26	32	10	68
4236	0	17	34	8	59
4237	0	18	26	10	54
4238	0	26	35	11	72
4239	0	17	22	9	48
4240	0	20	37	10	67
4241	0	22	21	8	51
4242	0	31	33	9	73
4243	0	18	32	8	58
4244	0	25	21	9	55
4245	0	21	31	8	60
4246	0	18	31	8	57
4247	0	20	27	5	52
4248	0	25	25	10	60
4249	0	23	21	8	52
4250	0	25	19	13	57
4251	0	26	26	9	61
4252	0	20	32	5	57
4253	0	22	24	11	57
4254	0	18	16	8	42
4255	0	24	26	12	62
4256	0	24	31	6	61
4257	0	31	36	6	73
4258	0	25	24	10	59
4259	0	24	28	8	60
4260	0	15	25	8	48
4261	0	23	32	11	66
4262	0	19	30	10	59
4263	0	19	41	12	72
4264	0	21	28	13	62
4265	0	24	27	8	59
4266	0	20	25	7	52
4267	0	22	35	8	65
4268	0	20	33	8	61
4269	0	15	22	8	45
4270	0	24	22	4	50
4271	0	16	20	9	45
4272	0	21	24	5	50
4273	0	21	24	9	54
4274	0	19	26	11	56
4275	0	23	32	8	63
4276	0	18	40	6	64
4277	0	26	27	8	61
4278	0	21	28	6	55
4279	0	26	20	4	50
4280	0	21	34	9	64
4281	0	17	28	6	51
4282	0	20	20	9	49
4283	0	19	20	9	48
4284	0	21	23	9	53
4285	0	17	28	21	66
4286	0	22	32	10	64
4287	0	21	24	11	56
4288	0	30	20	6	56
4289	0	20	37	5	62
4290	0	20	24	5	49
4291	0	14	21	5	40
4292	0	15	31	13	59
4293	0	22	26	7	55
4294	0	27	31	11	69
4295	0	20	28	9	57
4296	0	27	29	11	67
4297	0	30	31	13	74
4298	0	23	29	15	67
4299	0	18	33	8	59
4300	0	19	27	8	54
4301	0	16	29	10	55
4302	0	20	21	13	54
4303	0	24	22	1	47
4304	0	29	15	7	51
4305	0	17	32	17	66
4306	0	32	32	5	69
4307	0	25	24	6	55
4308	0	31	24	9	64
4309	0	18	22	5	45
4310	0	11	18	7	36
4311	0	25	24	11	60
4312	0	15	32	5	52
4313	0	18	30	6	54
4314	0	27	37	7	71
4315	0	19	27	12	58
4316	0	31	31	8	70
4317	0	17	23	9	49
4318	0	18	25	4	47
4319	0	26	30	10	66
4320	0	23	27	7	57
4321	0	22	18	9	49
4322	0	32	23	8	63
4323	0	17	20	10	47
4324	0	25	23	6	54
4325	0	18	32	5	55
4326	0	18	31	8	57
4327	0	19	33	11	63
4328	0	19	24	8	51
4329	0	20	37	5	62
4330	0	23	28	6	57
4331	0	19	30	6	55
4332	0	25	25	9	59
4333	0	20	33	10	63
4334	0	18	26	8	52
4335	0	16	24	5	45
4336	0	24	24	10	58
4337	0	19	29	13	61
4338	0	17	24	13	54
4339	0	18	28	6	52
4340	0	22	15	8	45
4341	0	23	17	9	49
4342	0	18	34	7	59
4343	0	21	36	8	65
4344	0	19	31	12	62
4345	0	18	31	7	56
4346	0	28	25	6	59
4347	0	14	23	11	48
4348	0	26	18	14	58
4349	0	16	27	13	56
4350	0	25	31	6	62
4351	0	22	23	8	53
4352	0	25	26	6	57
4353	0	21	15	8	44
4354	0	21	24	9	54
4355	0	16	27	2	45
4356	0	14	27	11	52
4357	0	24	37	6	67
4358	0	20	27	13	60
4359	0	20	23	6	49
4360	0	21	37	11	69
4361	0	29	16	10	55
4362	0	22	27	12	61
4363	0	21	25	4	50
4364	0	26	24	14	64
4365	0	15	21	14	50
4366	0	26	26	10	62
4367	0	21	22	5	48
4368	0	17	27	6	50
4369	0	22	27	8	57
4370	0	16	22	11	49
4371	0	20	24	8	52
4372	0	19	22	7	48
4373	0	15	32	15	62
4374	0	19	32	12	63
4375	0	19	21	9	49
4376	0	19	31	9	59
4377	0	18	29	8	55
4378	0	16	21	7	44
4379	0	18	27	10	55
4380	0	25	27	8	60
4381	0	21	27	5	53
4382	0	24	24	10	58
4383	0	15	18	5	38
4384	0	16	27	8	51
4385	0	18	27	7	52
4386	0	25	26	4	55
4387	0	18	25	15	58
4388	0	24	21	7	52
4389	0	15	23	12	50
4390	0	17	22	4	43
4391	0	19	31	8	58
4392	0	31	29	6	66
4393	0	22	26	11	59
4394	0	25	38	10	73
4395	0	25	23	10	58
4396	0	16	30	5	51
4397	0	13	31	10	54
4398	0	21	17	11	49
4399	0	20	23	6	49
4400	0	15	19	9	43
4401	0	24	25	7	56
4402	0	23	23	7	53
4403	0	22	19	9	50
4404	0	14	29	12	55
4405	0	28	20	7	55
4406	0	26	22	9	57
4407	0	21	23	6	50
4408	0	15	16	7	38
4409	0	16	26	3	45
4410	0	23	20	7	50
4411	0	13	29	9	51
4412	0	17	21	10	48
4413	0	14	26	7	47
4414	0	9	25	12	46
4415	0	17	26	9	52
4416	0	20	25	8	53
4417	0	16	31	14	61
4418	0	18	31	12	61
4419	0	13	19	10	42
4420	0	23	23	11	57
4421	0	17	19	11	47
4422	0	22	30	6	58
4423	0	25	19	9	53
4424	0	11	35	6	52
4425	0	22	17	9	48
4426	0	22	17	8	47
4427	0	20	35	7	62
4428	0	17	31	8	56
4429	0	18	23	7	48
4430	0	23	28	9	60
4431	0	17	23	10	50
4432	0	20	40	8	68
4433	0	18	15	9	42
4434	0	18	20	6	44
4435	0	24	33	11	68
4436	0	15	20	11	46
4437	0	18	17	6	41
4438	0	22	30	5	57
4439	0	21	25	9	55
4440	0	23	25	7	55
4441	0	18	27	5	50
4442	0	17	23	13	53
4443	0	15	12	7	34
4444	0	16	30	7	53
4445	0	28	25	12	65
4446	0	21	33	10	64
4447	0	20	22	9	51
4448	0	23	24	10	57
4449	0	16	25	7	48
4450	0	13	30	13	56
4451	0	15	22	7	44
4452	0	26	19	10	55
4453	0	23	33	8	64
4454	0	17	22	4	43
4455	0	14	20	6	40
4456	0	23	23	13	59
4457	0	16	24	12	52
4458	0	17	27	7	51
4459	0	14	26	14	54
4460	0	22	15	8	45
4461	0	14	25	9	48
4462	0	27	28	4	59
4463	0	23	11	10	44
4464	0	20	22	12	54
4465	0	19	28	10	57
4466	0	17	19	9	45
4467	0	20	31	10	61
4468	0	23	18	7	48
4469	0	20	31	9	60
4470	0	15	16	8	39
4471	0	18	27	18	63
4472	0	20	23	7	50
4473	0	15	28	3	46
4474	0	16	23	5	44
4475	0	17	23	5	45
4476	0	24	24	10	58
4477	0	16	31	9	56
4478	0	18	18	10	46
4479	0	16	21	7	44
4480	0	20	24	5	49
4481	0	15	39	10	64
4482	0	15	14	6	35
4483	0	19	18	5	42
4484	0	22	29	6	57
4485	0	16	20	12	48
4486	0	16	13	10	39
4487	0	18	24	10	52
4488	0	25	33	13	71
4489	0	19	21	9	49
4490	0	18	29	8	55
4491	0	18	20	5	43
4492	0	22	20	8	50
4493	0	26	29	10	65
4494	0	15	26	4	45
4495	0	22	28	15	65
4496	0	14	22	5	41
4497	0	20	22	7	49
4498	0	17	23	3	43
4499	0	15	32	4	51
4500	0	14	17	13	44
4501	0	18	22	4	44
4502	0	16	31	7	54
4503	0	26	25	9	60
4504	0	17	26	5	48
4505	0	19	25	14	58
4506	0	21	23	12	56
4507	0	19	19	11	49
4508	0	24	23	10	57
4509	0	19	22	11	52
4510	0	15	34	5	54
4511	0	17	25	9	51
4512	0	13	18	8	39
4513	0	19	17	7	43
4514	0	14	25	3	42
4515	0	15	18	10	43
4516	0	16	22	4	42
4517	0	15	19	6	40
4518	0	15	19	8	42
4519	0	16	24	13	53
4520	0	18	16	8	42
4521	0	22	21	11	54
4522	0	12	26	5	43
4523	0	14	30	9	53
4524	0	19	25	11	55
4525	0	27	33	16	76
4526	0	15	22	8	45
4527	0	19	23	4	46
4528	0	23	21	7	51
4529	0	14	20	12	46
4530	0	10	17	4	31
4531	0	13	14	8	35
4532	0	31	26	12	69
4533	0	20	23	5	48
4534	0	17	21	7	45
4535	0	28	20	3	51
4536	0	11	27	8	46
4537	0	23	28	9	60
4538	0	26	26	12	64
4539	0	24	17	8	49
4540	0	22	29	13	64
4541	0	17	22	5	44
4542	0	24	35	5	64
4543	0	8	29	9	46
4544	0	12	22	4	38
4545	0	18	19	6	43
4546	0	20	22	6	48
4547	0	16	22	4	42
4548	0	26	26	10	62
4549	0	19	25	7	51
4550	0	19	17	11	47
4551	0	24	24	6	54
4552	0	18	15	10	43
4553	0	12	26	9	47
4554	0	17	18	6	41
4555	0	27	25	4	56
4556	0	20	16	4	40
4557	0	21	16	6	43
4558	0	17	20	6	43
4559	0	17	15	11	43
4560	0	18	22	8	48
4561	0	23	26	10	59
4562	0	19	29	10	58
4563	0	27	25	9	61
4564	0	22	28	12	62
4565	0	21	27	10	58
4566	0	22	17	9	48
4567	0	18	21	8	47
4568	0	13	19	6	38
4569	0	15	28	12	55
4570	0	19	21	7	47
4571	0	25	30	9	64
4572	0	24	28	7	59
4573	0	25	26	3	54
4574	0	27	28	7	62
4575	0	19	28	13	60
4576	0	10	25	5	40
4577	0	27	14	7	48
4578	0	18	24	6	48
4579	0	24	31	5	60
4580	0	19	24	7	50
4581	0	22	28	5	55
4582	0	23	19	8	50
4583	0	15	19	11	45
4584	0	13	19	2	34
4585	0	19	27	8	54
4586	0	14	19	4	37
4587	0	16	33	8	57
4588	0	22	19	11	52
4589	0	18	24	6	48
4590	0	16	22	7	45
4591	0	14	19	9	42
4592	0	23	21	8	52
4593	0	13	22	5	40
4594	0	12	26	9	47
4595	0	24	22	7	53
4596	0	23	17	5	45
4597	0	19	28	5	52
4598	0	12	22	8	42
4599	0	12	24	10	46
4600	0	15	15	14	44
4601	0	19	18	6	43
4602	0	25	20	5	50
4603	0	10	24	7	41
4604	0	17	34	6	57
4605	0	20	28	8	56
4606	0	14	16	3	33
4607	0	14	19	6	39
4608	0	16	19	6	41
4609	0	24	24	9	57
4610	0	16	27	2	45
4611	0	24	25	9	58
4612	0	15	27	4	46
4613	0	22	21	8	51
4614	0	23	34	6	63
4615	0	9	20	2	31
4616	0	16	20	7	43
4617	0	18	27	4	49
4618	0	11	25	9	45
4619	0	18	19	5	42
4620	0	14	25	9	48
4621	0	15	26	3	44
4622	0	35	21	8	64
4623	0	20	23	6	49
4624	0	23	18	10	51
4625	0	11	22	5	38
4626	0	12	23	10	45
4627	0	15	25	6	46
4628	0	20	19	7	46
4629	0	22	27	8	57
4630	0	22	30	8	60
4631	0	15	15	4	34
4632	0	15	24	2	41
4633	0	20	27	4	51
4634	0	15	30	6	51
4635	0	23	30	3	56
4636	0	21	16	13	50
4637	0	14	30	9	53
4638	0	18	23	8	49
4639	0	16	21	5	42
4640	0	20	25	4	49
4641	0	18	18	9	45
4642	0	18	20	5	43
4643	0	14	19	10	43
4644	0	15	24	1	40
4645	0	10	24	8	42
4646	0	22	17	10	49
4647	0	17	15	11	43
4648	0	14	17	6	37
4649	0	19	19	8	46
4650	0	23	22	6	51
4651	0	20	32	7	59
4652	0	17	26	5	48
4653	0	21	21	3	45
4654	0	18	19	6	43
4655	0	10	26	7	43
4656	0	17	20	5	42
4657	0	24	24	4	52
4658	0	25	24	10	59
4659	0	26	14	5	45
4660	0	20	21	11	52
4661	0	18	24	3	45
4662	0	18	22	5	45
4663	0	9	24	5	38
4664	0	25	12	6	43
4665	0	17	21	7	45
4666	0	21	29	6	56
4667	0	7	22	6	35
4668	0	19	15	6	40
4669	0	18	18	8	44
4670	0	15	31	13	59
4671	0	23	22	7	52
4672	0	22	21	6	49
4673	0	10	16	5	31
4674	0	11	33	9	53
4675	0	23	19	4	46
4676	0	16	21	9	46
4677	0	13	27	6	46
4678	0	21	15	3	39
4679	0	17	24	7	48
4680	0	16	17	6	39
4681	0	14	19	7	40
4682	0	16	22	6	44
4683	0	20	21	7	48
4684	0	19	22	6	47
4685	0	26	21	5	52
4686	0	20	24	5	49
4687	0	13	18	11	42
4688	0	17	23	12	52
4689	0	18	28	4	50
4690	0	23	25	9	57
4691	0	19	15	9	43
4692	0	14	18	6	38
4693	0	22	17	5	44
4694	0	14	10	10	34
4695	0	22	16	7	45
4696	0	13	21	10	44
4697	0	16	19	3	38
4698	0	11	19	5	35
4699	0	15	19	10	44
4700	0	14	21	6	41
4701	0	26	23	7	56
4702	0	15	19	5	39
4703	0	15	22	9	46
4704	0	19	23	8	50
4705	0	11	24	5	40
4706	0	20	20	8	48
4707	0	9	19	8	36
4708	0	25	16	8	49
4709	0	18	26	8	52
4710	0	17	16	6	39
4711	0	20	29	12	61
4712	0	17	31	9	57
4713	0	21	17	4	42
4714	0	23	21	5	49
4715	0	22	26	6	54
4716	0	17	23	7	47
4717	0	13	17	6	36
4718	0	16	19	11	46
4719	0	18	21	6	45
4720	0	16	15	5	36
4721	0	14	15	10	39
4722	0	15	24	1	40
4723	0	13	17	6	36
4724	0	22	22	6	50
4725	0	20	13	5	38
4726	0	16	16	11	43
4727	0	15	15	4	34
4728	0	13	18	6	37
4729	0	19	18	5	42
4730	0	19	22	7	48
4731	0	21	25	5	51
4732	0	17	17	7	41
4733	0	10	20	6	36
4734	0	13	24	7	44
4735	0	16	23	5	44
4736	0	11	20	7	38
4737	0	19	15	6	40
4738	0	23	22	2	47
4739	0	18	15	7	40
4740	0	14	25	4	43
4741	0	13	16	11	40
4742	0	22	16	7	45
4743	0	17	21	6	44
4744	0	16	22	6	44
4745	0	15	15	8	38
4746	0	14	17	3	34
4747	0	21	20	10	51
4748	0	15	27	2	44
4749	0	22	25	7	54
4750	0	19	15	5	39
4751	0	23	27	3	53
4752	0	18	17	8	43
4753	0	16	20	5	41
4754	0	24	16	6	46
4755	0	9	18	9	36
4756	0	17	24	8	49
4757	0	21	16	7	44
4758	0	12	30	3	45
4759	0	14	26	12	52
4760	0	24	17	5	46
4761	0	15	22	4	41
4762	0	13	23	5	41
4763	0	17	20	9	46
4764	0	16	19	7	42
4765	0	27	16	10	53
4766	0	16	16	10	42
4767	0	19	28	8	55
4768	0	12	16	12	40
4769	0	11	19	4	34
4770	0	13	16	6	35
4771	0	16	24	8	48
4772	0	21	19	6	46
4773	0	17	24	3	44
4774	0	18	20	5	43
4775	0	13	12	7	32
4776	0	10	29	11	50
4777	0	16	18	8	42
4778	0	22	17	5	44
4779	0	15	22	7	44
4780	0	11	23	6	40
4781	0	14	23	5	42
4782	0	19	17	7	43
4783	0	16	20	6	42
4784	0	23	16	4	43
4785	0	16	23	4	43
4786	0	14	16	6	36
4787	0	16	37	2	55
4788	0	10	16	5	31
4789	0	18	16	12	46
4790	0	16	24	5	45
4791	0	14	15	4	33
4792	0	16	36	10	62
4793	0	15	22	10	47
4794	0	23	24	8	55
4795	0	12	14	4	30
4796	0	20	21	8	49
4797	0	17	24	4	45
4798	0	16	22	9	47
4799	0	20	23	5	48
4800	0	17	14	7	38
4801	0	18	13	2	33
4802	0	22	19	5	46
4803	0	9	15	4	28
4804	0	23	17	2	42
4805	0	16	21	4	41
4806	0	10	16	5	31
4807	0	17	16	4	37
4808	0	15	21	7	43
4809	0	18	25	11	54
4810	0	15	26	9	50
4811	0	18	16	12	46
4812	0	13	18	5	36
4813	0	16	20	10	46
4814	0	13	13	8	34
4815	0	12	17	3	32
4816	0	14	16	7	37
4817	0	15	12	4	31
4818	0	11	22	4	37
4819	0	13	22	5	40
4820	0	20	27	10	57
4821	0	13	20	3	36
4822	0	16	30	8	54
4823	0	15	21	6	42
4824	0	10	19	5	34
4825	0	16	26	3	45
4826	0	15	29	7	51
4827	0	16	25	3	44
4828	0	10	18	6	34
4829	0	15	18	11	44
4830	0	19	22	9	50
4831	0	12	17	6	35
4832	0	16	24	6	46
4833	0	9	23	10	42
4834	0	20	25	7	52
4835	0	17	19	5	41
4836	0	15	28	5	48
4837	0	16	21	13	50
4838	0	16	23	7	46
4839	0	14	18	6	38
4840	0	18	17	6	41
4841	0	6	29	4	39
4842	0	18	13	7	38
4843	0	15	27	7	49
4844	0	12	29	6	47
4845	0	10	19	5	34
4846	0	18	22	6	46
4847	0	17	19	7	43
4848	0	12	17	4	33
4849	0	16	15	8	39
4850	0	21	20	7	48
4851	0	16	24	8	48
4852	0	14	27	8	49
4853	0	12	22	6	40
4854	0	22	16	5	43
4855	0	22	20	8	50
4856	0	24	20	8	52
4857	0	17	14	9	40
4858	0	18	20	1	39
4859	0	14	20	2	36
4860	0	24	17	0	41
4861	0	18	22	2	42
4862	0	13	19	3	35
4863	0	16	33	6	55
4864	0	20	19	3	42
4865	0	20	18	6	44
4866	0	27	16	5	48
4867	0	12	23	7	42
4868	0	14	18	7	39
4869	0	18	16	9	43
4870	0	15	18	7	40
4871	0	16	32	8	56
4872	0	17	19	5	41
4873	0	13	20	6	39
4874	0	16	22	5	43
4875	0	21	22	3	46
4876	0	20	20	4	44
4877	0	16	19	7	42
4878	0	14	22	4	40
4879	0	9	21	7	37
4880	0	12	29	5	46
4881	0	10	19	9	38
4882	0	17	21	4	42
4883	0	21	19	4	44
4884	0	12	29	4	45
4885	0	16	26	8	50
4886	0	13	18	6	37
4887	0	17	22	3	42
4888	0	10	17	7	34
4889	0	22	11	7	40
4890	0	15	20	10	45
4891	0	18	21	3	42
4892	0	15	21	3	39
4893	0	19	12	3	34
4894	0	17	20	5	42
4895	0	14	14	5	33
4896	0	21	23	8	52
4897	0	17	28	1	46
4898	0	16	26	3	45
4899	0	10	17	6	33
4900	0	19	24	7	50
4901	0	15	14	6	35
4902	0	9	24	6	39
4903	0	13	20	5	38
4904	0	15	18	6	39
4905	0	8	20	13	41
4906	0	12	23	3	38
4907	0	20	16	5	41
4908	0	12	24	4	40
4909	0	8	23	2	33
4910	0	13	15	11	39
4911	0	18	16	10	44
4912	0	18	30	5	53
4913	0	14	20	5	39
4914	0	12	25	7	44
4915	0	14	20	6	40
4916	0	19	24	9	52
4917	0	12	21	6	39
4918	0	19	18	2	39
4919	0	14	18	6	38
4920	0	17	21	5	43
4921	0	17	14	8	39
4922	0	18	22	4	44
4923	0	19	20	13	52
4924	0	18	9	4	31
4925	0	14	19	7	40
4926	0	16	19	7	42
4927	0	21	19	3	43
4928	0	13	19	7	39
4929	0	20	16	3	39
4930	0	21	16	7	44
4931	0	16	18	7	41
4932	0	20	17	7	44
4933	0	16	15	4	35
4934	0	17	11	8	36
4935	0	17	27	4	48
4936	0	16	16	10	42
4937	0	13	18	4	35
4938	0	14	18	5	37
4939	0	16	19	9	44
4940	0	25	20	8	53
4941	0	15	12	10	37
4942	0	17	16	7	40
4943	0	20	21	5	46
4944	0	16	25	6	47
4945	0	10	24	6	40
4946	0	16	24	9	49
4947	0	11	19	7	37
4948	0	19	29	9	57
4949	0	18	22	2	42
4950	0	14	16	10	40
4951	0	12	13	8	33
4952	0	17	23	9	49
4953	0	14	17	4	35
4954	0	9	26	4	39
4955	0	13	21	8	42
4956	0	18	22	6	46
4957	0	15	19	6	40
4958	0	16	22	7	45
4959	0	19	23	7	49
4960	0	15	28	4	47
4961	0	14	20	14	48
4962	0	13	22	10	45
4963	0	12	14	15	41
4964	0	15	14	7	36
4965	0	12	25	6	43
4966	0	16	27	5	48
4967	0	13	18	4	35
4968	0	9	16	5	30
4969	0	18	13	12	43
4970	0	15	22	6	43
4971	0	16	20	8	44
4972	0	9	20	7	36
4973	0	11	23	10	44
4974	0	16	28	9	53
4975	0	13	16	3	32
4976	0	8	21	9	38
4977	0	12	12	9	33
4978	0	15	20	6	41
4979	0	11	18	9	38
4980	0	14	22	9	45
4981	0	14	25	13	52
4982	0	17	19	7	43
4983	0	15	18	14	47
4984	0	18	19	5	42
4985	0	11	14	4	29
4986	0	13	17	14	44
4987	0	16	16	13	45
4988	0	6	23	8	37
4989	0	18	18	13	49
4990	0	7	18	6	31
4991	0	6	29	5	40
4992	0	19	18	3	40
4993	0	11	32	3	46
4994	0	10	21	6	37
4995	0	17	18	8	43
4996	0	20	17	5	42
4997	0	7	23	11	41
4998	0	14	18	6	38
4999	0	13	15	6	34
5000	0	16	22	7	45
5001	0	14	13	9	36
5002	0	12	13	3	28
5003	0	21	18	3	42
5004	0	15	11	9	35
5005	0	14	14	7	35
5006	0	19	27	6	52
5007	0	20	17	6	43
5008	0	17	24	2	43
5009	0	10	21	6	37
5010	0	14	21	4	39
5011	0	21	19	5	45
5012	0	18	16	6	40
5013	0	14	17	6	37
5014	0	19	16	6	41
5015	0	13	25	2	40
5016	0	18	14	10	42
5017	0	17	20	2	39
5018	0	11	18	9	38
5019	0	14	14	7	35
5020	0	12	15	4	31
5021	0	14	23	9	46
5022	0	12	16	1	29
5023	0	13	15	6	34
5024	0	20	17	1	38
5025	0	10	9	5	24
5026	0	13	17	5	35
5027	0	15	14	10	39
5028	0	18	20	8	46
5029	0	9	22	8	39
5030	0	13	18	7	38
5031	0	10	33	2	45
5032	0	18	12	5	35
5033	0	10	15	4	29
5034	0	13	19	2	34
5035	0	12	19	11	42
5036	0	12	24	5	41
5037	0	14	13	4	31
5038	0	17	19	9	45
5039	0	13	16	9	38
5040	0	17	24	4	45
5041	0	12	15	5	32
5042	0	14	18	8	40
5043	0	12	18	10	40
5044	0	17	13	9	39
5045	0	12	16	7	35
5046	0	12	17	6	35
5047	0	12	24	7	43
5048	0	12	27	12	51
5049	0	14	19	5	38
5050	0	6	18	7	31
5051	0	10	18	8	36
5052	0	14	10	4	28
5053	0	13	14	2	29
5054	0	12	22	6	40
5055	0	15	14	5	34
5056	0	15	9	5	29
5057	0	11	18	5	34
5058	0	16	19	7	42
5059	0	20	13	6	39
5060	0	19	17	5	41
5061	0	15	19	4	38
5062	0	9	14	7	30
5063	0	8	18	5	31
5064	0	15	15	2	32
5065	0	12	19	9	40
5066	0	17	15	3	35
5067	0	25	21	3	49
5068	0	15	21	7	43
5069	0	19	15	5	39
5070	0	17	24	3	44
5071	0	15	16	4	35
5072	0	16	26	4	46
5073	0	17	21	2	40
5074	0	16	18	6	40
5075	0	19	15	6	40
5076	0	13	14	8	35
5077	0	22	20	5	47
5078	0	11	14	5	30
5079	0	12	21	5	38
5080	0	12	17	4	33
5081	0	10	25	6	41
5082	0	14	10	4	28
5083	0	11	13	6	30
5084	0	13	21	9	43
5085	0	15	13	5	33
5086	0	7	23	8	38
5087	0	16	11	8	35
5088	0	15	17	5	37
5089	0	15	19	3	37
5090	0	10	9	4	23
5091	0	17	15	6	38
5092	0	14	14	6	34
5093	0	14	15	8	37
5094	0	15	27	7	49
5095	0	15	16	3	34
5096	0	23	16	6	45
5097	0	17	11	8	36
5098	0	14	14	8	36
5099	0	14	18	6	38
5100	0	15	15	5	35
5101	0	14	15	5	34
5102	0	9	19	4	32
5103	0	10	20	7	37
5104	0	9	10	6	25
5105	0	12	23	7	42
5106	0	12	21	5	38
5107	0	15	20	7	42
5108	0	17	12	3	32
5109	0	16	18	9	43
5110	0	22	21	6	49
5111	0	14	25	5	44
5112	0	9	11	4	24
5113	0	12	18	2	32
5114	0	18	22	7	47
5115	0	13	10	6	29
5116	0	12	14	5	31
5117	0	11	14	7	32
5118	0	11	15	9	35
5119	0	20	15	7	42
5120	0	14	22	5	41
5121	0	9	16	5	30
5122	0	18	18	8	44
5123	0	12	10	7	29
5124	0	13	14	6	33
5125	0	15	19	9	43
5126	0	18	21	7	46
5127	0	9	17	7	33
5128	0	12	15	9	36
5129	0	7	16	8	31
5130	0	12	16	5	33
5131	0	10	21	8	39
5132	0	9	11	7	27
5133	0	14	20	8	42
5134	0	16	10	4	30
5135	0	16	18	5	39
5136	0	12	11	4	27
5137	0	15	19	5	39
5138	0	19	17	6	42
5139	0	15	22	6	43
5140	0	11	20	11	42
5141	0	10	27	8	45
5142	0	15	7	4	26
5143	0	20	12	9	41
5144	0	6	19	4	29
5145	0	8	12	6	26
5146	0	13	17	6	36
5147	0	7	16	8	31
5148	0	15	10	6	31
5149	0	13	25	6	44
5150	0	22	17	8	47
5151	0	11	23	6	40
5152	0	20	18	8	46
5153	0	11	17	10	38
5154	0	12	15	6	33
5155	0	12	13	7	32
5156	0	14	17	6	37
5157	0	10	14	8	32
5158	0	14	17	6	37
5159	0	12	16	3	31
5160	0	8	18	5	31
5161	0	14	15	5	34
5162	0	13	18	1	32
5163	0	13	15	7	35
5164	0	8	24	3	35
5165	0	8	19	4	31
5166	0	10	17	9	36
5167	0	16	15	9	40
5168	0	14	14	4	32
5169	0	18	22	2	42
5170	0	13	20	7	40
5171	0	20	19	4	43
5172	0	13	13	6	32
5173	0	11	23	8	42
5174	0	14	10	6	30
5175	0	14	14	9	37
5176	0	13	18	3	34
5177	0	17	19	5	41
5178	0	16	16	6	38
5179	0	9	13	7	29
5180	0	13	13	5	31
5181	0	10	12	6	28
5182	0	16	17	5	38
5183	0	18	21	5	44
5184	0	9	21	1	31
5185	0	9	17	6	32
5186	0	11	18	3	32
5187	0	18	15	3	36
5188	0	16	21	8	45
5189	0	10	19	6	35
5190	0	22	21	3	46
5191	0	12	18	4	34
5192	0	14	15	7	36
5193	0	10	21	4	35
5194	0	23	11	6	40
5195	0	11	19	2	32
5196	0	11	22	4	37
5197	0	12	16	8	36
5198	0	13	15	6	34
5199	0	14	17	6	37
5200	0	20	14	5	39
5201	0	13	17	5	35
5202	0	9	17	6	32
5203	0	18	13	2	33
5204	0	10	18	2	30
5205	0	15	26	6	47
5206	0	19	13	5	37
5207	0	23	17	4	44
5208	0	13	15	9	37
5209	0	16	18	5	39
5210	0	17	24	4	45
5211	0	14	17	5	36
5212	0	9	15	5	29
5213	0	8	17	6	31
5214	0	16	15	5	36
5215	0	14	20	3	37
5216	0	10	23	4	37
5217	0	7	16	3	26
5218	0	11	13	4	28
5219	0	8	23	10	41
5220	0	11	17	4	32
5221	0	15	21	4	40
5222	0	12	18	2	32
5223	0	10	20	6	36
5224	0	12	21	11	44
5225	0	20	17	7	44
5226	0	13	17	8	38
5227	0	7	19	6	32
5228	0	15	16	3	34
5229	0	11	21	5	37
5230	0	17	15	8	40
5231	0	12	17	2	31
5232	0	14	21	9	44
5233	0	15	14	5	34
5234	0	15	16	5	36
5235	0	15	20	10	45
5236	0	13	18	5	36
5237	0	15	22	1	38
5238	0	13	16	2	31
5239	0	10	16	12	38
5240	0	11	21	4	36
5241	0	14	24	4	42
5242	0	16	11	6	33
5243	0	13	11	4	28
5244	0	14	21	4	39
5245	0	15	13	10	38
5246	0	14	9	7	30
5247	0	4	15	7	26
5248	0	20	15	5	40
5249	0	16	16	4	36
5250	0	12	14	6	32
5251	0	12	14	7	33
5252	0	10	13	4	27
5253	0	9	16	4	29
5254	0	13	14	2	29
5255	0	16	17	6	39
5256	0	15	22	2	39
5257	0	11	18	4	33
5258	0	14	14	4	32
5259	0	15	18	1	34
5260	0	8	13	5	26
5261	0	18	14	6	38
5262	0	10	13	4	27
5263	0	13	10	2	25
5264	0	6	16	2	24
5265	0	16	18	3	37
5266	0	16	22	3	41
5267	0	12	14	7	33
5268	0	8	17	3	28
5269	0	10	14	7	31
5270	0	11	13	4	28
5271	0	14	21	4	39
5272	0	13	17	4	34
5273	0	26	17	8	51
5274	0	15	19	6	40
5275	0	10	16	5	31
5276	0	17	10	6	33
5277	0	8	14	8	30
5278	0	14	19	3	36
5279	0	13	14	6	33
5280	0	13	17	4	34
5281	0	17	17	6	40
5282	0	22	17	4	43
5283	0	18	21	3	42
5284	0	22	17	4	43
5285	0	13	19	5	37
5286	0	9	19	5	33
5287	0	20	16	4	40
5288	0	8	17	3	28
5289	0	22	18	9	49
5290	0	11	15	5	31
5291	0	12	16	6	34
5292	0	17	23	8	48
5293	0	14	20	13	47
5294	0	11	18	3	32
5295	0	19	17	3	39
5296	0	15	24	6	45
5297	0	10	12	2	24
5298	0	15	17	5	37
5299	0	9	16	4	29
5300	0	13	12	1	26
5301	0	11	11	9	31
5302	0	9	19	2	30
5303	0	12	10	14	36
5304	0	5	14	9	28
5305	0	15	19	7	41
5306	0	9	14	8	31
5307	0	11	15	2	28
5308	0	16	14	3	33
5309	0	14	20	4	38
5310	0	13	17	3	33
5311	0	16	13	5	34
5312	0	9	18	4	31
5313	0	10	9	7	26
5314	0	10	12	5	27
5315	0	14	17	4	35
5316	0	11	18	2	31
5317	0	15	16	3	34
5318	0	11	17	7	35
5319	0	11	19	7	37
5320	0	16	17	7	40
5321	0	14	13	1	28
5322	0	13	18	7	38
5323	0	17	21	3	41
5324	0	9	11	7	27
5325	0	16	14	5	35
5326	0	8	25	3	36
5327	0	7	20	4	31
5328	0	11	15	9	35
5329	0	6	11	7	24
5330	0	12	19	6	37
5331	0	11	21	7	39
5332	0	18	17	7	42
5333	0	7	15	2	24
5334	0	16	22	4	42
5335	0	17	22	3	42
5336	0	12	16	5	33
5337	0	18	16	5	39
5338	0	12	13	6	31
5339	0	16	10	12	38
5340	0	6	15	8	29
5341	0	11	15	9	35
5342	0	10	12	3	25
5343	0	9	23	2	34
5344	0	17	23	4	44
5345	0	14	16	3	33
5346	0	12	12	6	30
5347	0	21	16	6	43
5348	0	10	9	5	24
5349	0	17	9	4	30
5350	0	11	13	6	30
5351	0	16	21	5	42
5352	0	14	24	8	46
5353	0	10	12	5	27
5354	0	20	18	3	41
5355	0	11	30	6	47
5356	0	11	13	4	28
5357	0	14	15	4	33
5358	0	15	14	8	37
5359	0	11	13	4	28
5360	0	16	16	4	36
5361	0	13	11	7	31
5362	0	12	13	6	31
5363	0	4	6	4	14
5364	0	12	18	6	36
5365	0	10	13	9	32
5366	0	7	12	4	23
5367	0	14	17	11	42
5368	0	9	23	3	35
5369	0	20	13	1	34
5370	0	17	19	7	43
5371	0	10	17	7	34
5372	0	11	19	5	35
5373	0	14	14	8	36
5374	0	10	14	5	29
5375	0	12	12	6	30
5376	0	9	16	3	28
5377	0	7	22	5	34
5378	0	23	24	4	51
5379	0	20	13	3	36
5380	0	12	17	5	34
5381	0	16	12	4	32
5382	0	10	11	1	22
5383	0	12	16	3	31
5384	0	8	16	4	28
5385	0	11	17	2	30
5386	0	9	21	6	36
5387	0	16	14	6	36
5388	0	13	13	4	30
5389	0	14	11	6	31
5390	0	9	11	4	24
5391	0	20	14	6	40
5392	0	10	11	5	26
5393	0	7	12	3	22
5394	0	13	12	4	29
5395	0	13	18	6	37
5396	0	14	13	2	29
5397	0	4	16	4	24
5398	0	9	16	1	26
5399	0	6	19	3	28
5400	0	16	17	5	38
5401	0	9	19	5	33
5402	0	19	16	5	40
5403	0	12	12	8	32
5404	0	12	18	10	40
5405	0	12	15	3	30
5406	0	11	17	2	30
5407	0	13	17	5	35
5408	0	15	18	4	37
5409	0	18	15	8	41
5410	0	18	16	6	40
5411	0	11	18	9	38
5412	0	10	16	5	31
5413	0	9	14	4	27
5414	0	17	19	2	38
5415	0	10	17	2	29
5416	0	14	17	1	32
5417	0	12	24	5	41
5418	0	18	8	4	30
5419	0	16	8	2	26
5420	0	16	17	4	37
5421	0	10	17	5	32
5422	0	12	11	10	33
5423	0	13	18	3	34
5424	0	12	15	2	29
5425	0	15	13	4	32
5426	0	17	17	4	38
5427	0	13	11	7	31
5428	0	11	15	3	29
5429	0	8	21	6	35
5430	0	10	19	7	36
5431	0	3	12	3	18
5432	0	9	12	5	26
5433	0	10	19	0	29
5434	0	8	16	2	26
5435	0	17	21	2	40
5436	0	12	9	6	27
5437	0	13	17	12	42
5438	0	13	19	2	34
5439	0	10	21	4	35
5440	0	9	20	3	32
5441	0	11	10	3	24
5442	0	11	20	6	37
5443	0	13	16	10	39
5444	0	9	20	4	33
5445	0	12	13	6	31
5446	0	18	9	3	30
5447	0	13	17	11	41
5448	0	13	10	4	27
5449	0	16	14	3	33
5450	0	13	18	4	35
5451	0	8	14	10	32
5452	0	7	15	4	26
5453	0	8	22	1	31
5454	0	13	9	7	29
5455	0	14	23	4	41
5456	0	11	15	12	38
5457	0	16	15	2	33
5458	0	11	13	6	30
5459	0	9	19	6	34
5460	0	5	23	14	42
5461	0	8	16	5	29
5462	0	10	16	4	30
5463	0	23	12	3	38
5464	0	18	12	6	36
5465	0	6	18	7	31
5466	0	13	15	3	31
5467	0	13	15	4	32
5468	0	12	16	5	33
5469	0	7	18	5	30
5470	0	9	17	3	29
5471	0	7	15	5	27
5472	0	10	13	6	29
5473	0	10	12	5	27
5474	0	9	16	7	32
5475	0	14	11	4	29
5476	0	16	14	4	34
5477	0	13	21	6	40
5478	0	17	14	5	36
5479	0	15	13	6	34
5480	0	9	14	5	28
5481	0	14	18	5	37
5482	0	15	20	4	39
5483	0	8	17	6	31
5484	0	4	15	10	29
5485	0	11	16	5	32
5486	0	9	14	5	28
5487	0	11	11	4	26
5488	0	12	8	3	23
5489	0	12	13	4	29
5490	0	6	15	1	22
5491	0	9	17	2	28
5492	0	9	18	0	27
5493	0	16	14	8	38
5494	0	12	15	5	32
5495	0	13	10	5	28
5496	0	15	13	6	34
5497	0	11	6	8	25
5498	0	9	11	10	30
5499	0	21	21	1	43
5500	0	8	11	7	26
5501	0	16	10	1	27
5502	0	12	16	9	37
5503	0	7	18	2	27
5504	0	14	15	5	34
5505	0	16	15	5	36
5506	0	14	19	1	34
5507	0	8	12	5	25
5508	0	7	17	8	32
5509	0	16	8	3	27
5510	0	14	15	5	34
5511	0	14	17	1	32
5512	0	10	17	6	33
5513	0	5	10	3	18
5514	0	12	17	3	32
5515	0	9	12	6	27
5516	0	15	13	3	31
5517	0	6	16	5	27
5518	0	10	13	7	30
5519	0	11	13	4	28
5520	0	13	21	4	38
5521	0	14	10	3	27
5522	0	11	22	3	36
5523	0	15	8	4	27
5524	0	13	17	3	33
5525	0	10	11	4	25
5526	0	11	12	3	26
5527	0	10	10	4	24
5528	0	11	25	3	39
5529	0	11	19	2	32
5530	0	16	11	14	41
5531	0	13	16	5	34
5532	0	11	15	3	29
5533	0	6	14	4	24
5534	0	9	15	8	32
5535	0	9	14	2	25
5536	0	12	9	4	25
5537	0	8	16	5	29
5538	0	12	14	9	35
5539	0	9	17	2	28
5540	0	9	17	4	30
5541	0	11	16	3	30
5542	0	12	11	4	27
5543	0	9	13	2	24
5544	0	17	14	6	37
5545	0	11	17	3	31
5546	0	12	14	6	32
5547	0	7	12	5	24
5548	0	16	13	8	37
5549	0	8	18	6	32
5550	0	11	15	2	28
5551	0	13	14	3	30
5552	0	14	17	4	35
5553	0	12	14	5	31
5554	0	8	15	6	29
5555	0	14	18	4	36
5556	0	21	13	3	37
5557	0	13	18	9	40
5558	0	12	12	9	33
5559	0	12	8	6	26
5560	0	13	14	5	32
5561	0	9	15	5	29
5562	0	10	11	9	30
5563	0	10	15	4	29
5564	0	7	8	3	18
5565	0	16	15	5	36
5566	0	10	15	4	29
5567	0	13	8	4	25
5568	0	12	12	4	28
5569	0	13	9	2	24
5570	0	10	17	4	31
5571	0	5	12	8	25
5572	0	13	13	4	30
5573	0	17	14	4	35
5574	0	11	11	3	25
5575	0	9	20	4	33
5576	0	11	22	2	35
5577	0	11	10	6	27
5578	0	17	10	2	29
5579	0	9	13	3	25
5580	0	11	15	2	28
5581	0	7	14	10	31
5582	0	9	16	4	29
5583	0	14	16	2	32
5584	0	8	11	7	26
5585	0	10	11	5	26
5586	0	17	21	6	44
5587	0	13	17	8	38
5588	0	8	18	3	29
5589	0	10	16	7	33
5590	0	11	10	2	23
5591	0	15	10	5	30
5592	0	12	16	2	30
5593	0	12	12	0	24
5594	0	19	12	5	36
5595	0	8	13	3	24
5596	0	9	17	5	31
5597	0	10	10	1	21
5598	0	8	13	5	26
5599	0	9	7	4	20
5600	0	9	11	3	23
5601	0	12	16	3	31
5602	0	12	12	3	27
5603	0	13	17	3	33
5604	0	14	21	5	40
5605	0	15	16	5	36
5606	0	9	11	6	26
5607	0	9	15	7	31
5608	0	7	14	7	28
5609	0	8	9	3	20
5610	0	11	9	5	25
5611	0	15	12	3	30
5612	0	11	11	6	28
5613	0	9	15	4	28
5614	0	7	26	5	38
5615	0	9	19	5	33
5616	0	13	14	8	35
5617	0	9	9	2	20
5618	0	19	14	5	38
5619	0	21	10	7	38
5620	0	9	17	3	29
5621	0	11	5	8	24
5622	0	11	16	4	31
5623	0	10	17	5	32
5624	0	14	18	2	34
5625	0	7	18	7	32
5626	0	11	15	7	33
5627	0	10	8	6	24
5628	0	15	17	5	37
5629	0	12	6	6	24
5630	0	8	13	4	25
5631	0	10	10	7	27
5632	0	18	18	1	37
5633	0	10	15	6	31
5634	0	15	19	1	35
5635	0	15	18	4	37
5636	0	14	12	3	29
5637	0	9	25	4	38
5638	0	13	13	7	33
5639	0	11	10	1	22
5640	0	7	22	7	36
5641	0	9	12	2	23
5642	0	9	12	0	21
5643	0	15	17	3	35
5644	0	8	14	4	26
5645	0	11	12	7	30
5646	0	13	12	5	30
5647	0	13	8	4	25
5648	0	10	10	7	27
5649	0	18	8	8	34
5650	0	19	13	3	35
5651	0	12	17	7	36
5652	0	14	13	5	32
5653	0	4	18	5	27
5654	0	10	16	8	34
5655	0	13	11	5	29
5656	0	6	12	8	26
5657	0	12	17	5	34
5658	0	13	10	2	25
5659	0	17	11	6	34
5660	0	9	17	4	30
5661	0	8	16	4	28
5662	0	15	8	8	31
5663	0	7	7	8	22
5664	0	15	12	2	29
5665	0	13	16	4	33
5666	0	13	13	2	28
5667	0	10	11	9	30
5668	0	16	17	4	37
5669	0	11	19	6	36
5670	0	13	12	3	28
5671	0	10	10	5	25
5672	0	10	8	4	22
5673	0	5	11	11	27
5674	0	9	8	3	20
5675	0	10	16	7	33
5676	0	16	11	5	32
5677	0	7	21	5	33
5678	0	13	10	5	28
5679	0	12	15	4	31
5680	0	22	15	5	42
5681	0	8	13	4	25
5682	0	8	15	5	28
5683	0	9	9	2	20
5684	0	13	8	2	23
5685	0	9	8	4	21
5686	0	10	16	6	32
5687	0	8	10	5	23
5688	0	11	14	3	28
5689	0	9	13	6	28
5690	0	14	16	6	36
5691	0	9	7	9	25
5692	0	9	18	4	31
5693	0	9	9	7	25
5694	0	8	9	6	23
5695	0	9	9	4	22
5696	0	17	12	4	33
5697	0	12	17	1	30
5698	0	12	16	6	34
5699	0	13	11	2	26
5700	0	13	7	3	23
5701	0	9	19	5	33
5702	0	13	12	6	31
5703	0	10	11	3	24
5704	0	12	13	5	30
5705	0	15	22	5	42
5706	0	9	8	1	18
5707	0	12	11	3	26
5708	0	13	13	5	31
5709	0	8	18	10	36
5710	0	8	19	4	31
5711	0	11	13	6	30
5712	0	13	16	2	31
5713	0	12	14	1	27
5714	0	16	17	5	38
5715	0	15	12	0	27
5716	0	8	12	7	27
5717	0	7	10	6	23
5718	0	12	11	7	30
5719	0	14	14	8	36
5720	0	13	13	7	33
5721	0	18	11	4	33
5722	0	18	11	2	31
5723	0	14	8	2	24
5724	0	18	9	7	34
5725	0	10	14	9	33
5726	0	13	13	3	29
5727	0	11	18	3	32
5728	0	12	16	6	34
5729	0	11	21	4	36
5730	0	13	22	5	40
5731	0	11	11	7	29
5732	0	14	17	4	35
5733	0	3	17	4	24
5734	0	9	13	2	24
5735	0	8	19	9	36
5736	0	10	15	2	27
5737	0	6	14	4	24
5738	0	6	13	5	24
5739	0	4	16	6	26
5740	0	7	8	7	22
5741	0	4	17	2	23
5742	0	10	16	6	32
5743	0	10	17	3	30
5744	0	8	15	3	26
5745	0	14	10	8	32
5746	0	15	8	5	28
5747	0	12	9	2	23
5748	0	12	11	4	27
5749	0	17	9	5	31
5750	0	14	13	5	32
5751	0	10	9	10	29
5752	0	13	18	4	35
5753	0	13	18	4	35
5754	0	15	10	1	26
5755	0	11	8	6	25
5756	0	11	13	3	27
5757	0	16	15	3	34
5758	0	11	16	4	31
5759	0	12	18	4	34
5760	0	15	5	3	23
5761	0	14	9	4	27
5762	0	4	16	3	23
5763	0	9	9	6	24
5764	0	11	14	4	29
5765	0	9	15	5	29
5766	0	10	21	3	34
5767	0	10	8	4	22
5768	0	8	15	3	26
5769	0	10	9	5	24
5770	0	6	12	5	23
5771	0	17	17	6	40
5772	0	9	20	2	31
5773	0	14	12	3	29
5774	0	14	11	5	30
5775	0	9	13	5	27
5776	0	8	8	4	20
5777	0	8	17	2	27
5778	0	8	8	5	21
5779	0	13	8	3	24
5780	0	15	15	2	32
5781	0	16	13	4	33
5782	0	10	16	3	29
5783	0	11	13	5	29
5784	0	10	10	4	24
5785	0	6	12	2	20
5786	0	14	16	3	33
5787	0	12	11	5	28
5788	0	12	11	4	27
5789	0	6	17	2	25
5790	0	13	15	5	33
5791	0	12	7	7	26
5792	0	10	15	3	28
5793	0	13	11	7	31
5794	0	9	19	7	35
5795	0	12	10	6	28
5796	0	9	10	4	23
5797	0	11	15	4	30
5798	0	6	12	7	25
5799	0	16	15	3	34
5800	0	11	7	5	23
5801	0	9	14	6	29
5802	0	11	6	2	19
5803	0	13	20	5	38
5804	0	10	8	3	21
5805	0	6	8	3	17
5806	0	11	12	4	27
5807	0	11	4	5	20
5808	0	8	7	1	16
5809	0	13	8	3	24
5810	0	11	12	1	24
5811	0	9	11	6	26
5812	0	11	12	0	23
5813	0	11	11	6	28
5814	0	10	17	1	28
5815	0	10	12	2	24
5816	0	16	16	4	36
5817	0	7	19	1	27
5818	0	16	11	10	37
5819	0	7	12	7	26
5820	0	9	10	6	25
5821	0	6	13	7	26
5822	0	11	10	1	22
5823	0	9	15	4	28
5824	0	20	13	3	36
5825	0	9	14	5	28
5826	0	12	13	3	28
5827	0	2	13	3	18
5828	0	14	14	7	35
5829	0	11	9	7	27
5830	0	11	8	3	22
5831	0	11	8	7	26
5832	0	8	13	1	22
5833	0	8	5	2	15
5834	0	9	11	5	25
5835	0	7	12	5	24
5836	0	9	14	9	32
5837	0	9	18	7	34
5838	0	16	16	5	37
5839	0	11	11	5	27
5840	0	15	16	2	33
5841	0	7	15	4	26
5842	0	13	10	0	23
5843	0	12	18	4	34
5844	0	15	17	2	34
5845	0	9	12	4	25
5846	0	9	9	4	22
5847	0	13	18	3	34
5848	0	11	17	3	31
5849	0	14	16	5	35
5850	0	12	12	3	27
5851	0	7	13	6	26
5852	0	9	11	4	24
5853	0	13	10	3	26
5854	0	11	9	2	22
5855	0	11	10	2	23
5856	0	10	11	5	26
5857	0	8	16	1	25
5858	0	12	11	4	27
5859	0	15	11	2	28
5860	0	2	11	7	20
5861	0	9	19	0	28
5862	0	8	12	5	25
5863	0	5	10	5	20
5864	0	5	15	3	23
5865	0	6	9	8	23
5866	0	13	11	4	28
5867	0	7	13	7	27
5868	0	10	17	2	29
5869	0	8	12	4	24
5870	0	8	7	3	18
5871	0	5	5	3	13
5872	0	8	9	3	20
5873	0	10	10	2	22
5874	0	12	8	1	21
5875	0	12	7	1	20
5876	0	12	14	3	29
5877	0	9	3	3	15
5878	0	10	9	5	24
5879	0	6	12	9	27
5880	0	8	13	6	27
5881	0	10	14	2	26
5882	0	13	11	5	29
5883	0	8	16	7	31
5884	0	7	12	5	24
5885	0	11	9	5	25
5886	0	14	14	4	32
5887	0	17	11	2	30
5888	0	11	13	2	26
5889	0	8	14	7	29
5890	0	11	12	2	25
5891	0	10	9	1	20
5892	0	8	13	4	25
5893	0	11	16	1	28
5894	0	5	8	0	13
5895	0	7	12	3	22
5896	0	11	13	6	30
5897	0	10	12	6	28
5898	0	9	20	3	32
5899	0	8	11	4	23
5900	0	6	15	6	27
5901	0	9	19	3	31
5902	0	7	11	5	23
5903	0	9	14	6	29
5904	0	19	17	6	42
5905	0	9	10	3	22
5906	0	6	10	3	19
5907	0	9	15	3	27
5908	0	14	17	3	34
5909	0	9	14	3	26
5910	0	6	10	6	22
5911	0	5	6	4	15
5912	0	5	9	1	15
5913	0	5	14	5	24
5914	0	6	11	3	20
5915	0	5	14	4	23
5916	0	12	17	8	37
5917	0	9	8	6	23
5918	0	13	11	2	26
5919	0	13	7	1	21
5920	0	9	11	4	24
5921	0	10	8	2	20
5922	0	6	11	3	20
5923	0	6	15	3	24
5924	0	8	15	3	26
5925	0	7	18	2	27
5926	0	10	10	6	26
5927	0	10	20	3	33
5928	0	11	9	4	24
5929	0	10	13	4	27
5930	0	14	6	3	23
5931	0	10	16	3	29
5932	0	12	15	5	32
5933	0	12	17	4	33
5934	0	7	8	5	20
5935	0	13	9	3	25
5936	0	13	13	2	28
5937	0	11	13	4	28
5938	0	13	10	4	27
5939	0	7	12	3	22
5940	0	15	9	4	28
5941	0	7	6	2	15
5942	0	10	11	2	23
5943	0	8	10	1	19
5944	0	12	14	3	29
5945	0	5	7	5	17
5946	0	9	13	7	29
5947	0	9	11	2	22
5948	0	13	9	7	29
5949	0	9	8	2	19
5950	0	9	9	2	20
5951	0	5	9	3	17
5952	0	16	10	2	28
5953	0	10	15	4	29
5954	0	6	9	4	19
5955	0	8	10	4	22
5956	0	10	13	7	30
5957	0	6	17	2	25
5958	0	5	8	7	20
5959	0	8	19	3	30
5960	0	9	10	3	22
5961	0	9	16	3	28
5962	0	10	14	3	27
5963	0	9	9	1	19
5964	0	11	17	7	35
5965	0	11	12	3	26
5966	0	10	15	5	30
5967	0	6	10	6	22
5968	0	9	6	3	18
5969	0	6	8	4	18
5970	0	10	14	5	29
5971	0	15	14	4	33
5972	0	12	14	4	30
5973	0	5	19	4	28
5974	0	7	7	2	16
5975	0	6	12	3	21
5976	0	10	10	4	24
5977	0	12	11	5	28
5978	0	13	8	3	24
5979	0	12	8	0	20
5980	0	9	9	1	19
5981	0	10	12	2	24
5982	0	10	18	5	33
5983	0	4	8	6	18
5984	0	11	9	3	23
5985	0	10	13	3	26
5986	0	10	9	9	28
5987	0	6	11	4	21
5988	0	9	14	1	24
5989	0	9	9	3	21
5990	0	11	14	3	28
5991	0	3	17	4	24
5992	0	13	7	5	25
5993	0	12	16	1	29
5994	0	11	12	2	25
5995	0	7	11	5	23
5996	0	10	11	3	24
5997	0	14	8	3	25
5998	0	9	15	2	26
5999	0	6	10	6	22
6000	0	5	10	5	20
6001	0	10	12	8	30
6002	0	8	6	3	17
6003	0	3	17	5	25
6004	0	14	13	4	31
6005	0	8	12	3	23
6006	0	5	14	8	27
6007	0	11	14	4	29
6008	0	12	6	3	21
6009	0	10	10	4	24
6010	0	6	14	2	22
6011	0	6	15	7	28
6012	0	10	7	4	21
6013	0	10	7	5	22
6014	0	5	11	7	23
6015	0	8	10	5	23
6016	0	10	12	5	27
6017	0	6	10	6	22
6018	0	7	7	4	18
6019	0	11	15	4	30
6020	0	3	9	6	18
6021	0	8	13	10	31
6022	0	7	16	2	25
6023	0	4	14	0	18
6024	0	12	13	1	26
6025	0	9	9	3	21
6026	0	9	17	3	29
6027	0	9	11	7	27
6028	0	10	17	3	30
6029	0	9	8	2	19
6030	0	10	13	4	27
6031	0	9	11	4	24
6032	0	11	19	1	31
6033	0	9	13	6	28
6034	0	11	11	1	23
6035	0	10	12	4	26
6036	0	8	7	6	21
6037	0	8	6	5	19
6038	0	13	13	5	31
6039	0	7	7	1	15
6040	0	6	2	1	9
6041	0	11	12	2	25
6042	0	11	10	4	25
6043	0	6	14	5	25
6044	0	11	10	4	25
6045	0	8	9	4	21
6046	0	5	11	2	18
6047	0	15	8	2	25
6048	0	5	11	4	20
6049	0	6	8	6	20
6050	0	10	11	5	26
6051	0	13	14	6	33
6052	0	12	14	3	29
6053	0	9	8	4	21
6054	0	7	10	6	23
6055	0	4	15	5	24
6056	0	8	13	4	25
6057	0	8	8	2	18
6058	0	7	17	4	28
6059	0	14	15	6	35
6060	0	8	11	3	22
6061	0	7	17	3	27
6062	0	6	13	5	24
6063	0	8	14	4	26
6064	0	9	9	0	18
6065	0	13	15	8	36
6066	0	12	12	2	26
6067	0	11	19	1	31
6068	0	9	11	6	26
6069	0	10	10	5	25
6070	0	10	13	5	28
6071	0	10	10	3	23
6072	0	5	6	2	13
6073	0	9	8	7	24
6074	0	10	11	5	26
6075	0	10	9	3	22
6076	0	14	15	4	33
6077	0	7	13	6	26
6078	0	11	17	3	31
6079	0	8	6	5	19
6080	0	7	18	6	31
6081	0	5	13	4	22
6082	0	13	8	5	26
6083	0	8	13	4	25
6084	0	11	8	6	25
6085	0	6	13	6	25
6086	0	7	9	6	22
6087	0	7	10	6	23
6088	0	12	7	5	24
6089	0	8	11	2	21
6090	0	4	9	4	17
6091	0	6	7	4	17
6092	0	10	12	6	28
6093	0	8	12	1	21
6094	0	6	14	0	20
6095	0	6	6	4	16
6096	0	11	4	3	18
6097	0	7	12	2	21
6098	0	3	11	2	16
6099	0	9	12	4	25
6100	0	11	9	0	20
6101	0	6	10	2	18
6102	0	12	21	4	37
6103	0	7	9	3	19
6104	0	2	13	3	18
6105	0	6	6	7	19
6106	0	8	4	6	18
6107	0	4	8	3	15
6108	0	10	12	2	24
6109	0	4	7	3	14
6110	0	7	14	4	25
6111	0	12	11	1	24
6112	0	7	8	2	17
6113	0	9	12	2	23
6114	0	10	11	2	23
6115	0	8	8	4	20
6116	0	7	16	2	25
6117	0	8	8	3	19
6118	0	8	10	5	23
6119	0	9	11	3	23
6120	0	10	6	2	18
6121	0	8	13	7	28
6122	0	9	11	2	22
6123	0	3	9	4	16
6124	0	9	11	3	23
6125	0	9	9	2	20
6126	0	6	9	4	19
6127	0	15	17	0	32
6128	0	10	11	3	24
6129	0	9	20	2	31
6130	0	7	9	4	20
6131	0	4	10	3	17
6132	0	6	10	1	17
6133	0	7	13	2	22
6134	0	3	10	2	15
6135	0	11	13	4	28
6136	0	6	8	5	19
6137	0	5	13	3	21
6138	0	17	11	0	28
6139	0	11	9	2	22
6140	0	3	15	5	23
6141	0	7	13	2	22
6142	0	7	10	2	19
6143	0	14	9	2	25
6144	0	10	8	5	23
6145	0	7	14	4	25
6146	0	7	13	4	24
6147	0	7	15	0	22
6148	0	13	9	3	25
6149	0	4	10	3	17
6150	0	5	8	4	17
6151	0	6	10	2	18
6152	0	5	11	3	19
6153	0	11	8	3	22
6154	0	8	13	7	28
6155	0	12	10	5	27
6156	0	7	16	2	25
6157	0	10	9	7	26
6158	0	5	6	4	15
6159	0	11	9	5	25
6160	0	10	6	2	18
6161	0	4	14	1	19
6162	0	6	14	2	22
6163	0	4	11	3	18
6164	0	9	12	1	22
6165	0	7	7	0	14
6166	0	9	11	3	23
6167	0	12	12	3	27
6168	0	6	15	5	26
6169	0	13	2	7	22
6170	0	7	12	1	20
6171	0	7	8	4	19
6172	0	7	11	1	19
6173	0	10	14	4	28
6174	0	11	11	2	24
6175	0	12	11	5	28
6176	0	7	7	3	17
6177	0	7	9	2	18
6178	0	17	9	4	30
6179	0	8	7	2	17
6180	0	5	19	4	28
6181	0	8	20	1	29
6182	0	9	15	4	28
6183	0	8	9	6	23
6184	0	14	10	5	29
6185	0	7	9	3	19
6186	0	8	9	3	20
6187	0	3	8	5	16
6188	0	8	11	5	24
6189	0	14	6	0	20
6190	0	9	10	3	22
6191	0	8	13	5	26
6192	0	11	9	4	24
6193	0	5	12	1	18
6194	0	4	6	4	14
6195	0	7	13	1	21
6196	0	9	8	2	19
6197	0	7	11	1	19
6198	0	8	9	4	21
6199	0	11	8	1	20
6200	0	9	16	5	30
6201	0	11	9	3	23
6202	0	13	4	2	19
6203	0	8	8	0	16
6204	0	6	10	5	21
6205	0	9	9	3	21
6206	0	10	11	5	26
6207	0	14	12	5	31
6208	0	7	12	1	20
6209	0	5	12	0	17
6210	0	5	5	3	13
6211	0	10	5	4	19
6212	0	14	16	3	33
6213	0	2	5	6	13
6214	0	9	8	3	20
6215	0	13	12	4	29
6216	0	7	8	1	16
6217	0	10	21	7	38
6218	0	7	14	3	24
6219	0	7	9	4	20
6220	0	8	13	4	25
6221	0	6	14	4	24
6222	0	10	11	5	26
6223	0	5	4	4	13
6224	0	11	8	4	23
6225	0	5	7	4	16
6226	0	8	11	3	22
6227	0	9	9	2	20
6228	0	11	10	6	27
6229	0	13	12	7	32
6230	0	8	11	6	25
6231	0	5	2	8	15
6232	0	9	13	3	25
6233	0	6	11	4	21
6234	0	6	13	6	25
6235	0	10	3	7	20
6236	0	11	8	3	22
6237	0	5	14	1	20
6238	0	9	12	6	27
6239	0	4	8	4	16
6240	0	8	9	1	18
6241	0	5	7	4	16
6242	0	6	11	3	20
6243	0	8	5	6	19
6244	0	14	6	2	22
6245	0	9	12	5	26
6246	0	7	9	3	19
6247	0	3	16	2	21
6248	0	8	13	3	24
6249	0	9	8	4	21
6250	0	11	8	5	24
6251	0	4	4	2	10
6252	0	10	9	1	20
6253	0	10	7	5	22
6254	0	10	16	4	30
6255	0	9	7	5	21
6256	0	7	13	3	23
6257	0	9	14	4	27
6258	0	14	11	2	27
6259	0	7	8	4	19
6260	0	10	11	7	28
6261	0	3	8	8	19
6262	0	7	8	2	17
6263	0	4	14	2	20
6264	0	6	10	5	21
6265	0	6	8	2	16
6266	0	8	11	4	23
6267	0	8	11	3	22
6268	0	6	7	5	18
6269	0	5	6	5	16
6270	0	6	8	5	19
6271	0	8	13	3	24
6272	0	10	8	5	23
6273	0	10	5	2	17
6274	0	8	14	4	26
6275	0	4	7	3	14
6276	0	9	12	5	26
6277	0	7	7	2	16
6278	0	3	13	4	20
6279	0	14	7	5	26
6280	0	6	13	2	21
6281	0	6	14	4	24
6282	0	5	7	3	15
6283	0	8	5	4	17
6284	0	9	6	3	18
6285	0	7	12	2	21
6286	0	10	11	3	24
6287	0	12	17	2	31
6288	0	9	11	2	22
6289	0	16	10	6	32
6290	0	10	11	4	25
6291	0	5	13	3	21
6292	0	6	17	6	29
6293	0	5	4	3	12
6294	0	6	8	5	19
6295	0	10	11	6	27
6296	0	9	7	6	22
6297	0	8	10	3	21
6298	0	5	10	3	18
6299	0	2	9	7	18
6300	0	9	10	4	23
6301	0	5	15	3	23
6302	0	4	8	7	19
6303	0	7	12	3	22
6304	0	9	5	4	18
6305	0	3	9	2	14
6306	0	7	6	1	14
6307	0	8	13	1	22
6308	0	8	8	6	22
6309	0	4	11	3	18
6310	0	4	10	5	19
6311	0	8	8	0	16
6312	0	9	9	5	23
6313	0	4	9	3	16
6314	0	15	5	1	21
6315	0	11	11	3	25
6316	0	7	7	2	16
6317	0	11	13	6	30
6318	0	7	8	3	18
6319	0	10	11	2	23
6320	0	6	16	2	24
6321	0	3	9	4	16
6322	0	12	9	1	22
6323	0	9	7	1	17
6324	0	12	10	2	24
6325	0	8	10	1	19
6326	0	8	15	3	26
6327	0	8	10	4	22
6328	0	8	5	1	14
6329	0	4	5	5	14
6330	0	9	12	4	25
6331	0	4	10	1	15
6332	0	6	12	6	24
6333	0	11	11	4	26
6334	0	7	11	5	23
6335	0	12	8	1	21
6336	0	11	11	1	23
6337	0	11	14	1	26
6338	0	4	15	2	21
6339	0	6	13	5	24
6340	0	9	10	2	21
6341	0	11	5	3	19
6342	0	14	8	5	27
6343	0	6	9	5	20
6344	0	10	13	4	27
6345	0	5	15	6	26
6346	0	6	6	1	13
6347	0	7	12	0	19
6348	0	5	8	3	16
6349	0	8	7	3	18
6350	0	5	11	4	20
6351	0	8	10	4	22
6352	0	9	14	6	29
6353	0	9	9	4	22
6354	0	9	10	4	23
6355	0	12	13	2	27
6356	0	7	8	3	18
6357	0	8	12	3	23
6358	0	5	8	3	16
6359	0	11	10	1	22
6360	0	5	10	2	17
6361	0	12	9	3	24
6362	0	2	11	3	16
6363	0	11	4	3	18
6364	0	8	6	5	19
6365	0	6	9	1	16
6366	0	4	8	1	13
6367	0	10	9	2	21
6368	0	5	8	2	15
6369	0	13	4	2	19
6370	0	13	9	4	26
6371	0	8	6	0	14
6372	0	9	12	3	24
6373	0	11	10	2	23
6374	0	6	10	3	19
6375	0	4	8	8	20
6376	0	6	8	3	17
6377	0	4	8	6	18
6378	0	6	8	7	21
6379	0	10	16	6	32
6380	0	9	4	3	16
6381	0	11	16	5	32
6382	0	7	8	4	19
6383	0	8	5	2	15
6384	0	9	6	5	20
6385	0	7	7	3	17
6386	0	6	18	1	25
6387	0	14	12	6	32
6388	0	4	9	1	14
6389	0	7	9	4	20
6390	0	8	12	4	24
6391	0	4	13	2	19
6392	0	8	8	0	16
6393	0	7	14	4	25
6394	0	7	12	2	21
6395	0	9	10	5	24
6396	0	11	10	4	25
6397	0	9	10	2	21
6398	0	7	11	3	21
6399	0	3	16	3	22
6400	0	9	12	2	23
6401	0	12	11	3	26
6402	0	7	10	5	22
6403	0	12	11	2	25
6404	0	2	15	4	21
6405	0	7	11	4	22
6406	0	6	8	5	19
6407	0	4	13	4	21
6408	0	5	3	1	9
6409	0	8	6	5	19
6410	0	4	14	5	23
6411	0	8	12	1	21
6412	0	6	10	2	18
6413	0	12	7	3	22
6414	0	8	9	4	21
6415	0	10	9	3	22
6416	0	3	10	4	17
6417	0	8	10	3	21
6418	0	7	3	1	11
6419	0	6	11	2	19
6420	0	11	8	6	25
6421	0	2	10	2	14
6422	0	13	9	2	24
6423	0	8	5	2	15
6424	0	10	10	3	23
6425	0	8	12	1	21
6426	0	4	11	1	16
6427	0	10	10	2	22
6428	0	6	9	5	20
6429	0	7	9	1	17
6430	0	10	6	6	22
6431	0	9	11	1	21
6432	0	6	6	4	16
6433	0	7	9	1	17
6434	0	2	13	0	15
6435	0	8	9	3	20
6436	0	6	9	2	17
6437	0	8	8	2	18
6438	0	10	9	1	20
6439	0	6	10	6	22
6440	0	8	12	3	23
6441	0	3	9	0	12
6442	0	6	18	3	27
6443	0	4	8	3	15
6444	0	4	6	1	11
6445	0	8	6	4	18
6446	0	6	4	0	10
6447	0	7	8	3	18
6448	0	4	4	4	12
6449	0	6	8	4	18
6450	0	5	15	7	27
6451	0	6	7	0	13
6452	0	8	18	2	28
6453	0	5	8	0	13
6454	0	4	12	2	18
6455	0	11	5	6	22
6456	0	8	7	3	18
6457	0	4	7	4	15
6458	0	10	14	0	24
6459	0	12	7	6	25
6460	0	11	7	2	20
6461	0	7	14	0	21
6462	0	7	6	4	17
6463	0	3	8	1	12
6464	0	7	12	6	25
6465	0	4	5	1	10
6466	0	5	10	2	17
6467	0	10	14	2	26
6468	0	9	3	1	13
6469	0	8	10	3	21
6470	0	4	13	1	18
6471	0	5	9	3	17
6472	0	6	11	2	19
6473	0	5	7	1	13
6474	0	3	9	4	16
6475	0	5	11	4	20
6476	0	11	9	5	25
6477	0	8	8	2	18
6478	0	5	12	7	24
6479	0	8	10	1	19
6480	0	8	5	1	14
6481	0	6	13	4	23
6482	0	5	12	5	22
6483	0	3	13	3	19
6484	0	6	6	2	14
6485	0	7	6	3	16
6486	0	8	5	2	15
6487	0	14	8	1	23
6488	0	6	12	5	23
6489	0	5	5	4	14
6490	0	6	7	6	19
6491	0	18	8	5	31
6492	0	9	13	4	26
6493	0	4	14	2	20
6494	0	6	7	6	19
6495	0	5	6	4	15
6496	0	3	9	0	12
6497	0	4	5	1	10
6498	0	7	11	1	19
6499	0	7	8	4	19
6500	0	9	9	6	24
6501	0	6	9	3	18
6502	0	11	10	1	22
6503	0	7	4	6	17
6504	0	4	7	2	13
6505	0	11	10	3	24
6506	0	3	6	3	12
6507	0	6	7	4	17
6508	0	6	7	2	15
6509	0	6	7	2	15
6510	0	6	9	6	21
6511	0	9	10	1	20
6512	0	12	7	2	21
6513	0	3	8	2	13
6514	0	10	15	5	30
6515	0	5	8	2	15
6516	0	7	8	1	16
6517	0	4	8	4	16
6518	0	4	7	1	12
6519	0	6	12	3	21
6520	0	9	13	4	26
6521	0	7	9	3	19
6522	0	2	9	2	13
6523	0	9	7	1	17
6524	0	6	11	3	20
6525	0	7	8	3	18
6526	0	6	13	5	24
6527	0	7	8	2	17
6528	0	5	11	6	22
6529	0	7	8	2	17
6530	0	5	11	1	17
6531	0	3	10	2	15
6532	0	8	13	2	23
6533	0	8	7	7	22
6534	0	6	4	0	10
6535	0	4	10	4	18
6536	0	7	11	5	23
6537	0	7	8	3	18
6538	0	9	10	0	19
6539	0	10	10	3	23
6540	0	5	8	6	19
6541	0	7	15	3	25
6542	0	7	7	5	19
6543	0	8	10	2	20
6544	0	13	3	5	21
6545	0	9	12	1	22
6546	0	6	10	1	17
6547	0	5	4	3	12
6548	0	9	11	1	21
6549	0	6	6	1	13
6550	0	11	16	6	33
6551	0	6	7	2	15
6552	0	14	10	3	27
6553	0	2	8	5	15
6554	0	5	6	2	13
6555	0	5	8	2	15
6556	0	6	8	5	19
6557	0	6	7	2	15
6558	0	5	14	3	22
6559	0	8	8	4	20
6560	0	7	12	1	20
6561	0	9	12	3	24
6562	0	6	8	3	17
6563	0	10	11	2	23
6564	0	6	9	3	18
6565	0	9	7	1	17
6566	0	7	7	2	16
6567	0	9	11	1	21
6568	0	4	12	1	17
6569	0	8	8	3	19
6570	0	6	6	4	16
6571	0	9	8	3	20
6572	0	10	10	3	23
6573	0	4	7	1	12
6574	0	7	6	6	19
6575	0	4	7	2	13
6576	0	8	9	1	18
6577	0	7	12	3	22
6578	0	15	13	5	33
6579	0	6	6	2	14
6580	0	11	7	2	20
6581	0	7	9	5	21
6582	0	11	14	2	27
6583	0	3	9	2	14
6584	0	10	13	5	28
6585	0	4	9	4	17
6586	0	9	7	1	17
6587	0	6	6	3	15
6588	0	11	9	1	21
6589	0	5	7	3	15
6590	0	6	8	5	19
6591	0	11	10	4	25
6592	0	8	4	2	14
6593	0	10	9	4	23
6594	0	6	3	5	14
6595	0	5	7	4	16
6596	0	9	8	2	19
6597	0	2	8	2	12
6598	0	11	5	2	18
6599	0	6	9	3	18
6600	0	7	8	0	15
6601	0	6	5	3	14
6602	0	6	8	5	19
6603	0	6	11	3	20
6604	0	11	9	6	26
6605	0	6	5	3	14
6606	0	2	2	2	6
6607	0	3	12	4	19
6608	0	9	5	3	17
6609	0	11	12	3	26
6610	0	5	7	6	18
6611	0	8	7	5	20
6612	0	6	4	1	11
6613	0	7	8	5	20
6614	0	5	6	4	15
6615	0	7	10	3	20
6616	0	1	7	3	11
6617	0	8	13	5	26
6618	0	8	9	2	19
6619	0	6	6	3	15
6620	0	9	5	6	20
6621	0	7	5	1	13
6622	0	9	7	3	19
6623	0	5	5	3	13
6624	0	14	8	3	25
6625	0	6	7	5	18
6626	0	7	5	1	13
6627	0	11	10	2	23
6628	0	8	8	2	18
6629	0	7	10	4	21
6630	0	6	13	0	19
6631	0	12	11	5	28
6632	0	8	6	4	18
6633	0	6	7	2	15
6634	0	8	11	3	22
6635	0	12	7	2	21
6636	0	10	10	3	23
6637	0	1	4	1	6
6638	0	10	9	4	23
6639	0	5	10	1	16
6640	0	6	6	4	16
6641	0	5	9	2	16
6642	0	8	4	5	17
6643	0	4	12	3	19
6644	0	6	10	3	19
6645	0	5	9	2	16
6646	0	6	10	3	19
6647	0	8	14	2	24
6648	0	7	6	5	18
6649	0	4	9	4	17
6650	0	5	9	5	19
6651	0	10	5	2	17
6652	0	10	6	5	21
6653	0	5	5	4	14
6654	0	6	6	2	14
6655	0	4	11	3	18
6656	0	10	8	4	22
6657	0	6	9	0	15
6658	0	8	11	3	22
6659	0	7	7	4	18
6660	0	11	10	6	27
6661	0	7	8	3	18
6662	0	8	11	3	22
6663	0	7	8	3	18
6664	0	14	6	4	24
6665	0	10	11	2	23
6666	0	7	13	3	23
6667	0	8	10	2	20
6668	0	8	7	2	17
6669	0	10	6	2	18
6670	0	12	15	1	28
6671	0	12	3	2	17
6672	0	6	9	5	20
6673	0	6	13	2	21
6674	0	6	6	4	16
6675	0	4	11	5	20
6676	0	5	7	2	14
6677	0	8	9	3	20
6678	0	9	6	0	15
6679	0	10	12	1	23
6680	0	4	5	4	13
6681	0	12	7	4	23
6682	0	11	12	4	27
6683	0	13	8	3	24
6684	0	5	7	2	14
6685	0	3	13	1	17
6686	0	4	9	2	15
6687	0	4	10	6	20
6688	0	6	8	4	18
6689	0	1	8	2	11
6690	0	4	5	4	13
6691	0	6	11	0	17
6692	0	9	8	1	18
6693	0	9	2	2	13
6694	0	8	7	2	17
6695	0	7	12	2	21
6696	0	8	5	1	14
6697	0	5	9	1	15
6698	0	6	12	4	22
6699	0	4	4	4	12
6700	0	3	12	1	16
6701	0	9	12	2	23
6702	0	9	10	3	22
6703	0	9	12	2	23
6704	0	4	9	1	14
6705	0	7	7	1	15
6706	0	4	11	1	16
6707	0	4	9	3	16
6708	0	6	15	2	23
6709	0	6	5	2	13
6710	0	13	7	6	26
6711	0	4	8	5	17
6712	0	2	9	1	12
6713	0	4	3	1	8
6714	0	5	8	2	15
6715	0	2	5	2	9
6716	0	5	8	5	18
6717	0	10	8	5	23
6718	0	6	4	2	12
6719	0	8	7	3	18
6720	0	8	4	2	14
6721	0	4	8	1	13
6722	0	9	10	4	23
6723	0	9	10	3	22
6724	0	4	7	3	14
6725	0	8	7	1	16
6726	0	7	8	4	19
6727	0	7	6	3	16
6728	0	11	6	2	19
6729	0	3	11	2	16
6730	0	5	4	5	14
6731	0	7	7	2	16
6732	0	2	9	2	13
6733	0	4	12	0	16
6734	0	6	13	5	24
6735	0	8	10	8	26
6736	0	4	6	0	10
6737	0	10	12	5	27
6738	0	5	5	0	10
6739	0	5	7	3	15
6740	0	2	9	3	14
6741	0	7	5	3	15
6742	0	4	7	4	15
6743	0	5	11	4	20
6744	0	4	7	1	12
6745	0	9	10	5	24
6746	0	6	5	4	15
6747	0	13	13	3	29
6748	0	9	9	5	23
6749	0	6	6	3	15
6750	0	4	5	2	11
6751	0	6	7	3	16
6752	0	5	8	0	13
6753	0	6	9	2	17
6754	0	9	5	1	15
6755	0	5	7	3	15
6756	0	1	7	2	10
6757	0	3	12	2	17
6758	0	3	11	6	20
6759	0	5	9	3	17
6760	0	9	7	3	19
6761	0	5	8	2	15
6762	0	7	6	0	13
6763	0	5	7	1	13
6764	0	10	10	5	25
6765	0	4	9	3	16
6766	0	11	9	4	24
6767	0	10	7	6	23
6768	0	13	9	1	23
6769	0	3	7	0	10
6770	0	4	4	6	14
6771	0	6	9	2	17
6772	0	6	7	4	17
6773	0	7	11	2	20
6774	0	8	8	2	18
6775	0	8	6	6	20
6776	0	10	2	3	15
6777	0	7	8	4	19
6778	0	7	6	0	13
6779	0	1	9	7	17
6780	0	9	8	2	19
6781	0	12	4	0	16
6782	0	8	4	2	14
6783	0	5	10	2	17
6784	0	8	8	1	17
6785	0	9	4	3	16
6786	0	7	8	2	17
6787	0	5	11	3	19
6788	0	6	7	3	16
6789	0	6	12	3	21
6790	0	6	11	5	22
6791	0	5	6	4	15
6792	0	4	8	2	14
6793	0	6	7	4	17
6794	0	9	8	0	17
6795	0	8	9	1	18
6796	0	3	16	3	22
6797	0	7	8	2	17
6798	0	6	3	4	13
6799	0	7	9	1	17
6800	0	8	8	0	16
6801	0	2	10	3	15
6802	0	3	5	1	9
6803	0	5	9	2	16
6804	0	7	8	2	17
6805	0	7	5	3	15
6806	0	6	8	6	20
6807	0	7	5	6	18
6808	0	7	11	3	21
6809	0	4	7	6	17
6810	0	2	8	4	14
6811	0	6	7	1	14
6812	0	11	6	2	19
6813	0	6	8	2	16
6814	0	3	15	3	21
6815	0	7	8	3	18
6816	0	5	5	4	14
6817	0	7	3	2	12
6818	0	5	5	4	14
6819	0	5	9	1	15
6820	0	6	6	3	15
6821	0	7	4	3	14
6822	0	10	7	3	20
6823	0	7	4	4	15
6824	0	3	5	3	11
6825	0	6	8	2	16
6826	0	6	9	1	16
6827	0	6	9	1	16
6828	0	7	7	4	18
6829	0	5	9	1	15
6830	0	8	9	4	21
6831	0	2	7	0	9
6832	0	11	5	1	17
6833	0	9	8	1	18
6834	0	5	10	1	16
6835	0	4	6	3	13
6836	0	2	4	3	9
6837	0	5	8	3	16
6838	0	5	3	2	10
6839	0	10	7	1	18
6840	0	5	5	0	10
6841	0	8	9	4	21
6842	0	5	7	2	14
6843	0	8	6	2	16
6844	0	9	10	2	21
6845	0	8	7	1	16
6846	0	11	9	2	22
6847	0	3	6	0	9
6848	0	5	7	1	13
6849	0	11	6	2	19
6850	0	5	7	2	14
6851	0	7	12	2	21
6852	0	8	6	5	19
6853	0	3	7	3	13
6854	0	3	10	0	13
6855	0	6	13	6	25
6856	0	14	8	1	23
6857	0	3	9	0	12
6858	0	7	10	2	19
6859	0	10	9	1	20
6860	0	6	2	2	10
6861	0	8	6	1	15
6862	0	8	8	3	19
6863	0	6	8	4	18
6864	0	5	6	2	13
6865	0	4	6	1	11
6866	0	6	6	2	14
6867	0	7	6	3	16
6868	0	8	13	1	22
6869	0	8	6	4	18
6870	0	11	11	2	24
6871	0	12	10	2	24
6872	0	5	13	0	18
6873	0	7	9	0	16
6874	0	3	4	3	10
6875	0	9	12	1	22
6876	0	9	8	2	19
6877	0	6	7	2	15
6878	0	6	2	4	12
6879	0	3	6	2	11
6880	0	5	5	2	12
6881	0	5	13	0	18
6882	0	9	7	0	16
6883	0	6	8	0	14
6884	0	2	7	3	12
6885	0	5	6	5	16
6886	0	8	11	3	22
6887	0	5	7	8	20
6888	0	2	13	2	17
6889	0	0	4	2	6
6890	0	7	4	3	14
6891	0	3	5	2	10
6892	0	3	9	5	17
6893	0	5	11	2	18
6894	0	7	9	4	20
6895	0	8	4	2	14
6896	0	9	6	1	16
6897	0	8	6	3	17
6898	0	5	6	2	13
6899	0	6	5	1	12
6900	0	8	8	2	18
6901	0	10	8	5	23
6902	0	6	6	2	14
6903	0	4	12	1	17
6904	0	4	6	3	13
6905	0	4	6	6	16
6906	0	5	7	2	14
6907	0	4	12	2	18
6908	0	4	9	2	15
6909	0	3	9	4	16
6910	0	4	8	1	13
6911	0	9	7	3	19
6912	0	7	8	0	15
6913	0	5	8	1	14
6914	0	8	8	2	18
6915	0	9	6	1	16
6916	0	5	8	5	18
6917	0	4	6	6	16
6918	0	5	7	1	13
6919	0	3	4	3	10
6920	0	12	5	2	19
6921	0	6	7	0	13
6922	0	6	4	2	12
6923	0	4	8	6	18
6924	0	5	7	1	13
6925	0	7	12	5	24
6926	0	3	4	7	14
6927	0	5	1	3	9
6928	0	6	8	0	14
6929	0	8	4	1	13
6930	0	5	7	2	14
6931	0	8	12	3	23
6932	0	5	7	2	14
6933	0	8	11	1	20
6934	0	8	9	3	20
6935	0	12	7	4	23
6936	0	8	5	2	15
6937	0	7	4	4	15
6938	0	3	12	3	18
6939	0	6	10	2	18
6940	0	8	6	4	18
6941	0	7	4	1	12
6942	0	7	6	1	14
6943	0	4	9	3	16
6944	0	5	6	1	12
6945	0	13	4	2	19
6946	0	8	10	0	18
6947	0	5	9	2	16
6948	0	4	6	3	13
6949	0	3	11	3	17
6950	0	6	9	1	16
6951	0	8	4	3	15
6952	0	5	12	3	20
6953	0	5	9	2	16
6954	0	5	9	2	16
6955	0	9	4	3	16
6956	0	3	4	1	8
6957	0	7	5	0	12
6958	0	4	11	2	17
6959	0	13	14	3	30
6960	0	4	5	1	10
6961	0	5	7	0	12
6962	0	5	7	2	14
6963	0	3	2	1	6
6964	0	4	5	0	9
6965	0	3	10	4	17
6966	0	6	6	1	13
6967	0	7	13	2	22
6968	0	7	4	0	11
6969	0	6	10	0	16
6970	0	7	9	2	18
6971	0	5	6	3	14
6972	0	7	8	1	16
6973	0	5	7	0	12
6974	0	6	7	1	14
6975	0	6	7	1	14
6976	0	3	10	1	14
6977	0	8	8	4	20
6978	0	6	3	1	10
6979	0	4	6	0	10
6980	0	7	6	4	17
6981	0	5	5	0	10
6982	0	4	8	4	16
6983	0	8	5	0	13
6984	0	6	7	1	14
6985	0	4	8	2	14
6986	0	5	10	1	16
6987	0	4	7	2	13
6988	0	7	6	2	15
6989	0	8	6	2	16
6990	0	6	12	4	22
6991	0	6	11	4	21
6992	0	4	6	2	12
6993	0	10	11	1	22
6994	0	7	8	3	18
6995	0	3	9	1	13
6996	0	9	7	5	21
6997	0	6	5	0	11
6998	0	8	7	4	19
6999	0	8	6	2	16
7000	0	7	10	1	18
7001	0	4	9	2	15
7002	0	5	8	3	16
7003	0	5	6	0	11
7004	0	8	8	0	16
7005	0	3	5	4	12
7006	0	4	7	0	11
7007	0	11	11	4	26
7008	0	11	11	4	26
7009	0	10	11	1	22
7010	0	6	6	2	14
7011	0	8	12	6	26
7012	0	6	7	1	14
7013	0	7	8	1	16
7014	0	4	12	3	19
7015	0	1	7	4	12
7016	0	5	4	3	12
7017	0	5	6	2	13
7018	0	10	2	1	13
7019	0	10	10	1	21
7020	0	2	5	3	10
7021	0	7	9	0	16
7022	0	7	14	4	25
7023	0	8	7	3	18
7024	0	3	6	0	9
7025	0	4	3	3	10
7026	0	6	5	3	14
7027	0	3	5	1	9
7028	0	4	5	3	12
7029	0	4	7	4	15
7030	0	3	5	2	10
7031	0	4	7	3	14
7032	0	5	8	2	15
7033	0	5	10	2	17
7034	0	7	4	4	15
7035	0	2	3	3	8
7036	0	7	7	3	17
7037	0	3	5	2	10
7038	0	8	3	3	14
7039	0	3	6	1	10
7040	0	5	11	1	17
7041	0	10	7	1	18
7042	0	8	8	0	16
7043	0	5	7	1	13
7044	0	8	9	0	17
7045	0	9	11	5	25
7046	0	10	5	0	15
7047	0	8	6	1	15
7048	0	3	8	2	13
7049	0	6	9	0	15
7050	0	5	5	2	12
7051	0	5	8	2	15
7052	0	4	6	1	11
7053	0	10	10	5	25
7054	0	3	11	1	15
7055	0	4	8	3	15
7056	0	3	3	2	8
7057	0	8	9	1	18
7058	0	6	8	1	15
7059	0	6	9	1	16
7060	0	4	5	2	11
7061	0	7	6	2	15
7062	0	7	9	3	19
7063	0	4	5	1	10
7064	0	2	4	1	7
7065	0	4	8	4	16
7066	0	3	4	2	9
7067	0	6	12	6	24
7068	0	8	9	1	18
7069	0	4	2	2	8
7070	0	8	12	2	22
7071	0	3	8	4	15
7072	0	4	5	2	11
7073	0	8	2	3	13
7074	0	9	12	1	22
7075	0	7	16	4	27
7076	0	3	7	5	15
7077	0	6	6	4	16
7078	0	7	8	5	20
7079	0	1	4	4	9
7080	0	3	9	5	17
7081	0	7	5	3	15
7082	0	3	8	1	12
7083	0	6	11	0	17
7084	0	9	8	2	19
7085	0	5	8	1	14
7086	0	6	5	1	12
7087	0	4	8	2	14
7088	0	1	3	4	8
7089	0	5	7	2	14
7090	0	3	14	2	19
7091	0	6	5	2	13
7092	0	6	9	0	15
7093	0	4	1	1	6
7094	0	5	10	2	17
7095	0	6	10	3	19
7096	0	10	9	0	19
7097	0	7	8	4	19
7098	0	9	10	4	23
7099	0	5	5	4	14
7100	0	9	12	3	24
7101	0	6	7	3	16
7102	0	7	11	1	19
7103	0	6	2	1	9
7104	0	7	5	2	14
7105	0	7	5	1	13
7106	0	4	9	2	15
7107	0	9	5	2	16
7108	0	10	7	5	22
7109	0	5	9	3	17
7110	0	7	2	3	12
7111	0	8	6	5	19
7112	0	2	8	3	13
7113	0	6	9	2	17
7114	0	7	6	1	14
7115	0	8	5	0	13
7116	0	4	7	1	12
7117	0	4	5	2	11
7118	0	6	8	0	14
7119	0	10	6	1	17
7120	0	3	10	2	15
7121	0	7	8	2	17
7122	0	4	6	4	14
7123	0	5	4	2	11
7124	0	8	4	0	12
7125	0	4	7	2	13
7126	0	6	5	3	14
7127	0	3	7	2	12
7128	0	3	7	4	14
7129	0	6	4	2	12
7130	0	6	7	2	15
7131	0	3	5	2	10
7132	0	2	6	2	10
7133	0	8	9	2	19
7134	0	2	4	1	7
7135	0	8	10	1	19
7136	0	8	9	2	19
7137	0	4	8	2	14
7138	0	5	4	2	11
7139	0	3	8	3	14
7140	0	7	7	3	17
7141	0	4	8	2	14
7142	0	8	8	0	16
7143	0	8	13	3	24
7144	0	2	6	2	10
7145	0	6	8	2	16
7146	0	9	11	2	22
7147	0	4	6	2	12
7148	0	3	7	5	15
7149	0	4	6	4	14
7150	0	4	7	5	16
7151	0	5	11	3	19
7152	0	3	10	2	15
7153	0	12	5	2	19
7154	0	2	5	3	10
7155	0	6	11	2	19
7156	0	9	9	1	19
7157	0	8	9	1	18
7158	0	5	10	0	15
7159	0	5	5	2	12
7160	0	6	6	2	14
7161	0	8	7	2	17
7162	0	8	5	1	14
7163	0	2	9	3	14
7164	0	3	6	1	10
7165	0	5	6	2	13
7166	0	6	6	1	13
7167	0	6	10	5	21
7168	0	5	5	2	12
7169	0	3	4	2	9
7170	0	9	8	4	21
7171	0	4	6	0	10
7172	0	3	5	3	11
7173	0	9	4	2	15
7174	0	10	1	1	12
7175	0	6	5	0	11
7176	0	6	5	2	13
7177	0	5	6	2	13
7178	0	7	10	0	17
7179	0	7	10	1	18
7180	0	9	7	3	19
7181	0	7	3	3	13
7182	0	7	6	1	14
7183	0	6	6	3	15
7184	0	2	4	0	6
7185	0	6	6	2	14
7186	0	8	7	1	16
7187	0	8	6	5	19
7188	0	4	14	3	21
7189	0	5	7	2	14
7190	0	2	4	3	9
7191	0	5	8	2	15
7192	0	4	6	3	13
7193	0	4	5	4	13
7194	0	4	6	4	14
7195	0	7	11	0	18
7196	0	6	3	1	10
7197	0	4	7	2	13
7198	0	2	9	1	12
7199	0	7	7	2	16
7200	0	7	4	3	14
7201	0	5	12	4	21
7202	0	6	8	0	14
7203	0	5	7	0	12
7204	0	10	10	2	22
7205	0	9	4	0	13
7206	0	5	13	2	20
7207	0	6	3	3	12
7208	0	5	8	2	15
7209	0	3	7	2	12
7210	0	6	7	2	15
7211	0	8	6	3	17
7212	0	6	5	3	14
7213	0	7	9	3	19
7214	0	7	7	0	14
7215	0	6	8	1	15
7216	0	4	4	3	11
7217	0	4	4	3	11
7218	0	4	8	2	14
7219	0	11	9	3	23
7220	0	3	1	3	7
7221	0	3	6	1	10
7222	0	8	8	3	19
7223	0	3	16	2	21
7224	0	7	2	5	14
7225	0	11	7	3	21
7226	0	4	12	1	17
7227	0	1	3	3	7
7228	0	3	5	2	10
7229	0	8	7	1	16
7230	0	4	3	1	8
7231	0	6	6	0	12
7232	0	5	7	0	12
7233	0	2	4	2	8
7234	0	6	2	4	12
7235	0	1	10	1	12
7236	0	4	6	2	12
7237	0	7	13	2	22
7238	0	8	8	2	18
7239	0	9	2	3	14
7240	0	2	5	1	8
7241	0	3	9	1	13
7242	0	2	8	4	14
7243	0	8	3	0	11
7244	0	8	4	1	13
7245	0	7	1	3	11
7246	0	5	9	3	17
7247	0	9	6	3	18
7248	0	7	8	4	19
7249	0	6	6	4	16
7250	0	4	7	1	12
7251	0	4	10	3	17
7252	0	5	10	0	15
7253	0	2	4	3	9
7254	0	10	8	3	21
7255	0	7	7	3	17
7256	0	3	7	3	13
7257	0	4	5	3	12
7258	0	5	1	0	6
7259	0	3	11	2	16
7260	0	3	10	1	14
7261	0	5	4	4	13
7262	0	3	5	2	10
7263	0	1	3	1	5
7264	0	5	9	4	18
7265	0	4	4	2	10
7266	0	4	7	3	14
7267	0	5	7	1	13
7268	0	8	5	2	15
7269	0	2	5	2	9
7270	0	2	6	2	10
7271	0	1	6	0	7
7272	0	6	4	2	12
7273	0	7	6	1	14
7274	0	6	6	5	17
7275	0	11	4	2	17
7276	0	7	7	4	18
7277	0	5	8	1	14
7278	0	3	10	1	14
7279	0	5	8	0	13
7280	0	4	7	3	14
7281	0	7	11	0	18
7282	0	2	6	4	12
7283	0	4	4	0	8
7284	0	5	9	3	17
7285	0	0	6	2	8
7286	0	7	8	1	16
7287	0	2	4	0	6
7288	0	6	3	4	13
7289	0	7	4	0	11
7290	0	13	4	3	20
7291	0	5	3	3	11
7292	0	6	6	2	14
7293	0	1	6	0	7
7294	0	3	7	2	12
7295	0	4	9	1	14
7296	0	5	1	1	7
7297	0	11	5	1	17
7298	0	2	3	1	6
7299	0	10	6	3	19
7300	0	6	9	2	17
7301	0	2	7	2	11
7302	0	4	6	2	12
7303	0	5	5	0	10
7304	0	6	8	0	14
7305	0	6	9	3	18
7306	0	4	11	2	17
7307	0	6	9	2	17
7308	0	3	4	2	9
7309	0	4	5	1	10
7310	0	2	9	1	12
7311	0	2	5	2	9
7312	0	6	6	2	14
7313	0	3	6	3	12
7314	0	11	12	1	24
7315	0	5	8	0	13
7316	0	6	6	0	12
7317	0	2	5	2	9
7318	0	2	9	1	12
7319	0	5	9	1	15
7320	0	4	8	1	13
7321	0	3	2	4	9
7322	0	2	4	1	7
7323	0	4	7	1	12
7324	0	5	3	3	11
7325	0	4	5	2	11
7326	0	6	6	0	12
7327	0	9	6	2	17
7328	0	2	6	1	9
7329	0	8	4	3	15
7330	0	4	6	3	13
7331	0	5	7	4	16
7332	0	6	7	3	16
7333	0	10	8	3	21
7334	0	5	8	3	16
7335	0	3	2	2	7
7336	0	7	8	2	17
7337	0	5	8	4	17
7338	0	3	3	2	8
7339	0	4	8	1	13
7340	0	4	3	2	9
7341	0	9	5	3	17
7342	0	13	3	0	16
7343	0	2	2	2	6
7344	0	5	9	1	15
7345	0	4	10	4	18
7346	0	6	6	1	13
7347	0	3	5	1	9
7348	0	4	5	2	11
7349	0	3	3	3	9
7350	0	1	6	3	10
7351	0	6	11	2	19
7352	0	5	6	4	15
7353	0	3	10	1	14
7354	0	3	3	3	9
7355	0	7	9	2	18
7356	0	2	8	2	12
7357	1	4	8	3	16
7358	0	10	5	0	15
7359	0	6	7	1	14
7360	0	6	5	2	13
7361	0	2	14	0	16
7362	0	6	6	2	14
7363	0	2	5	1	8
7364	0	4	7	3	14
7365	0	5	2	1	8
7366	0	6	9	1	16
7367	0	6	6	3	15
7368	0	6	5	0	11
7369	0	4	7	2	13
7370	0	2	3	1	6
7371	0	2	5	1	8
7372	0	2	3	1	6
7373	0	5	9	0	14
7374	0	6	3	0	9
7375	0	11	7	2	20
7376	0	5	6	4	15
7377	0	5	5	3	13
7378	0	7	7	1	15
7379	0	1	9	0	10
7380	0	7	4	1	12
7381	0	7	7	4	18
7382	0	2	6	1	9
7383	0	6	6	3	15
7384	0	4	4	0	8
7385	0	2	8	0	10
7386	0	7	4	1	12
7387	0	7	6	2	15
7388	0	3	3	2	8
7389	0	5	8	1	14
7390	0	7	7	1	15
7391	0	4	10	2	16
7392	0	3	4	2	9
7393	0	4	13	1	18
7394	0	5	7	1	13
7395	0	3	12	3	18
7396	0	4	5	0	9
7397	0	4	7	1	12
7398	0	5	4	2	11
7399	0	1	9	5	15
7400	0	5	3	3	11
7401	0	3	5	2	10
7402	0	2	7	2	11
7403	0	7	5	2	14
7404	0	6	9	1	16
7405	0	6	7	1	14
7406	0	2	4	1	7
7407	0	6	7	1	14
7408	0	7	5	2	14
7409	0	6	10	2	18
7410	0	8	4	2	14
7411	0	4	7	0	11
7412	0	6	5	2	13
7413	0	4	6	1	11
7414	0	7	2	0	9
7415	0	3	9	2	14
7416	0	1	5	2	8
7417	0	5	7	4	16
7418	0	2	5	2	9
7419	0	2	9	1	12
7420	0	2	4	0	6
7421	0	7	7	2	16
7422	0	4	6	2	12
7423	0	7	7	1	15
7424	0	10	6	1	17
7425	0	6	7	5	18
7426	0	5	9	2	16
7427	0	5	2	5	12
7428	0	2	11	1	14
7429	0	3	2	0	5
7430	0	6	5	1	12
7431	0	3	1	4	8
7432	0	3	6	0	9
7433	0	6	9	1	16
7434	0	6	3	1	10
7435	0	6	10	0	16
7436	0	8	7	2	17
7437	0	4	7	3	14
7438	0	5	5	1	11
7439	0	3	9	1	13
7440	0	4	6	1	11
7441	0	8	5	1	14
7442	0	5	9	4	18
7443	0	6	2	0	8
7444	0	11	5	1	17
7445	0	1	5	2	8
7446	0	9	5	2	16
7447	0	5	6	2	13
7448	0	2	4	3	9
7449	0	2	7	5	14
7450	0	5	7	0	12
7451	0	5	5	0	10
7452	0	1	4	2	7
7453	0	8	4	0	12
7454	0	8	4	1	13
7455	0	6	4	3	13
7456	0	7	7	2	16
7457	0	4	3	2	9
7458	0	4	4	5	13
7459	0	8	5	1	14
7460	0	4	6	3	13
7461	0	4	5	2	11
7462	0	4	6	3	13
7463	0	8	6	4	18
7464	0	4	6	2	12
7465	0	6	7	0	13
7466	0	4	4	2	10
7467	0	3	9	2	14
7468	0	4	5	1	10
7469	0	7	1	3	11
7470	0	10	6	6	22
7471	0	4	8	3	15
7472	0	7	8	0	15
7473	0	8	6	0	14
7474	0	3	2	1	6
7475	0	6	2	2	10
7476	0	6	2	1	9
7477	0	6	7	2	15
7478	0	5	5	2	12
7479	0	5	5	1	11
7480	0	11	6	0	17
7481	0	4	5	1	10
7482	0	4	8	4	16
7483	0	2	4	3	9
7484	0	5	8	1	14
7485	0	3	5	1	9
7486	0	4	5	1	10
7487	0	2	8	1	11
7488	0	11	10	2	23
7489	0	5	5	4	14
7490	0	3	4	2	9
7491	0	7	3	1	11
7492	0	8	10	0	18
7493	0	4	1	3	8
7494	0	3	6	2	11
7495	0	2	4	2	8
7496	0	6	8	1	15
7497	0	1	2	1	4
7498	0	7	3	3	13
7499	0	7	7	1	15
7500	0	8	7	2	17
7501	0	1	6	3	10
7502	0	2	6	2	10
7503	0	8	8	6	22
7504	0	7	6	2	15
7505	0	6	5	1	12
7506	0	5	6	2	13
7507	0	4	5	4	13
7508	0	7	3	3	13
7509	0	4	4	1	9
7510	0	4	5	4	13
7511	0	5	7	1	13
7512	0	5	7	1	13
7513	0	6	11	1	18
7514	0	11	5	2	18
7515	0	4	8	0	12
7516	0	2	6	1	9
7517	0	10	4	2	16
7518	0	2	8	2	12
7519	0	2	8	1	11
7520	0	3	10	0	13
7521	0	1	9	2	12
7522	0	1	3	2	6
7523	0	9	6	1	16
7524	0	6	9	0	15
7525	0	3	6	4	13
7526	0	5	4	0	9
7527	0	4	6	4	14
7528	0	3	5	3	11
7529	0	2	8	2	12
7530	0	4	9	0	13
7531	0	4	2	0	6
7532	0	5	9	0	14
7533	0	7	3	1	11
7534	0	6	6	3	15
7535	0	2	10	1	13
7536	0	5	5	1	11
7537	0	4	6	0	10
7538	0	2	5	1	8
7539	0	3	4	2	9
7540	0	5	2	1	8
7541	0	4	3	0	7
7542	0	4	12	3	19
7543	0	8	2	2	12
7544	0	6	7	0	13
7545	0	6	4	1	11
7546	0	5	9	0	14
7547	0	2	3	2	7
7548	0	5	2	1	8
7549	0	8	8	2	18
7550	0	6	4	1	11
7551	0	7	4	2	13
7552	0	7	4	4	15
7553	0	1	7	2	10
7554	0	4	1	1	6
7555	0	6	6	2	14
7556	0	4	6	3	13
7557	0	8	2	1	11
7558	0	6	5	0	11
7559	0	6	6	2	14
7560	0	11	5	1	17
7561	0	2	9	2	13
7562	0	3	6	3	12
7563	0	5	8	1	14
7564	0	3	5	4	12
7565	0	4	3	2	9
7566	0	3	6	3	12
7567	0	7	4	3	14
7568	0	7	5	3	15
7569	0	5	5	2	12
7570	0	2	5	2	9
7571	0	4	13	0	17
7572	0	2	3	1	6
7573	0	8	4	1	13
7574	0	4	7	4	15
7575	0	5	3	2	10
7576	0	5	6	1	12
7577	0	3	3	1	7
7578	0	3	4	4	11
7579	0	9	5	1	15
7580	0	5	8	0	13
7581	0	5	3	2	10
7582	0	2	4	2	8
7583	0	3	8	1	12
7584	0	4	4	0	8
7585	0	6	3	2	11
7586	0	3	3	2	8
7587	0	3	9	0	12
7588	0	5	5	0	10
7589	0	3	5	1	9
7590	0	5	6	5	16
7591	0	7	6	3	16
7592	0	7	4	2	13
7593	0	6	8	1	15
7594	0	3	6	0	9
7595	0	3	5	1	9
7596	0	1	4	1	6
7597	0	3	3	1	7
7598	0	3	3	2	8
7599	0	5	5	0	10
7600	0	6	6	0	12
7601	0	3	5	2	10
7602	0	7	5	1	13
7603	0	3	3	0	6
7604	0	7	6	1	14
7605	0	3	4	3	10
7606	0	5	9	2	16
7607	0	5	4	2	11
7608	0	2	2	0	4
7609	0	7	9	0	16
7610	0	5	7	2	14
7611	0	6	5	4	15
7612	0	6	6	3	15
7613	0	4	4	1	9
7614	0	6	6	0	12
7615	0	5	3	5	13
7616	0	6	4	0	10
7617	0	4	5	2	11
7618	0	1	1	4	6
7619	0	3	9	1	13
7620	0	3	9	2	14
7621	0	4	1	0	5
7622	0	7	5	3	15
7623	0	2	6	1	9
7624	0	2	7	0	9
7625	0	8	6	1	15
7626	0	4	2	1	7
7627	0	7	6	1	14
7628	0	3	1	3	7
7629	0	4	4	3	11
7630	0	6	2	5	13
7631	0	4	5	1	10
7632	0	5	4	1	10
7633	0	7	2	0	9
7634	0	1	3	2	6
7635	0	6	3	1	10
7636	0	3	5	2	10
7637	0	4	7	2	13
7638	0	3	8	1	12
7639	0	4	3	2	9
7640	0	6	4	0	10
7641	0	8	10	3	21
7642	0	5	4	1	10
7643	0	2	6	5	13
7644	0	7	4	1	12
7645	0	4	5	0	9
7646	0	3	5	0	8
7647	0	1	3	2	6
7648	0	4	4	4	12
7649	0	1	5	1	7
7650	0	5	7	2	14
7651	0	7	1	2	10
7652	0	4	7	2	13
7653	0	4	4	0	8
7654	0	1	6	1	8
7655	0	4	3	3	10
7656	0	7	5	2	14
7657	0	4	7	3	14
7658	0	5	4	0	9
7659	0	5	9	1	15
7660	0	6	4	1	11
7661	0	5	8	0	13
7662	0	4	4	4	12
7663	0	2	4	0	6
7664	0	3	8	0	11
7665	0	6	5	0	11
7666	0	0	9	1	10
7667	0	4	3	0	7
7668	0	5	4	1	10
7669	0	1	7	2	10
7670	0	4	2	4	10
7671	0	2	8	4	14
7672	0	4	4	1	9
7673	0	6	5	3	14
7674	0	0	3	4	7
7675	0	6	8	3	17
7676	0	2	8	2	12
7677	0	5	9	2	16
7678	0	6	2	3	11
7679	0	0	6	0	6
7680	0	3	6	2	11
7681	0	3	3	2	8
7682	0	4	7	3	14
7683	0	8	4	1	13
7684	0	6	6	3	15
7685	0	3	3	1	7
7686	0	6	9	1	16
7687	0	2	7	5	14
7688	0	8	9	3	20
7689	0	3	1	0	4
7690	0	5	9	0	14
7691	0	5	4	3	12
7692	0	2	5	2	9
7693	0	7	4	1	12
7694	0	7	6	4	17
7695	0	4	7	3	14
7696	0	2	8	0	10
7697	0	8	5	0	13
7698	0	3	5	1	9
7699	0	3	6	3	12
7700	0	3	5	3	11
7701	0	4	3	3	10
7702	0	5	5	1	11
7703	0	1	5	1	7
7704	0	4	7	0	11
7705	0	4	9	2	15
7706	0	4	6	1	11
7707	0	3	7	1	11
7708	0	11	3	1	15
7709	0	1	8	0	9
7710	0	4	5	4	13
7711	0	2	6	1	9
7712	0	2	4	1	7
7713	0	3	3	1	7
7714	0	4	10	1	15
7715	0	12	5	1	18
7716	0	3	11	0	14
7717	0	2	6	2	10
7718	0	5	5	2	12
7719	0	4	6	0	10
7720	0	1	8	1	10
7721	0	6	6	1	13
7722	0	6	5	1	12
7723	0	5	1	2	8
7724	0	3	3	1	7
7725	0	1	8	3	12
7726	0	6	2	2	10
7727	0	7	8	0	15
7728	0	1	6	1	8
7729	0	6	7	1	14
7730	0	5	4	2	11
7731	0	6	9	1	16
7732	0	4	5	1	10
7733	0	3	9	2	14
7734	0	5	1	2	8
7735	0	7	2	3	12
7736	0	3	2	2	7
7737	0	6	7	2	15
7738	0	3	5	0	8
7739	0	2	6	2	10
7740	0	2	6	0	8
7741	0	1	2	1	4
7742	0	1	3	0	4
7743	0	7	7	2	16
7744	0	5	7	1	13
7745	0	3	2	0	5
7746	0	1	5	2	8
7747	0	8	6	1	15
7748	0	3	7	2	12
7749	0	4	2	0	6
7750	0	6	2	1	9
7751	0	4	3	3	10
7752	0	7	5	3	15
7753	0	2	5	1	8
7754	0	5	3	1	9
7755	0	5	5	1	11
7756	0	9	5	4	18
7757	0	3	3	1	7
7758	0	3	6	1	10
7759	0	4	4	1	9
7760	0	7	3	1	11
7761	0	3	10	2	15
7762	0	3	4	1	8
7763	0	7	4	2	13
7764	0	5	5	1	11
7765	0	3	8	1	12
7766	0	4	3	1	8
7767	0	4	6	1	11
7768	0	1	6	2	9
7769	0	2	5	0	7
7770	0	0	6	0	6
7771	0	3	9	0	12
7772	0	3	10	0	13
7773	0	3	10	1	14
7774	0	4	2	2	8
7775	0	8	5	0	13
7776	0	3	4	2	9
7777	0	5	4	1	10
7778	0	3	7	1	11
7779	0	6	4	3	13
7780	0	0	4	4	8
7781	0	3	5	3	11
7782	0	7	4	1	12
7783	0	3	3	3	9
7784	0	1	2	2	5
7785	0	3	8	3	14
7786	0	2	2	1	5
7787	0	5	4	2	11
7788	0	3	5	2	10
7789	0	3	3	2	8
7790	0	3	10	1	14
7791	0	6	9	2	17
7792	0	6	4	1	11
7793	0	7	6	1	14
7794	0	5	9	3	17
7795	0	4	7	3	14
7796	0	9	7	0	16
7797	0	5	7	0	12
7798	0	5	7	2	14
7799	0	7	2	2	11
7800	0	5	8	3	16
7801	0	4	4	1	9
7802	0	6	7	3	16
7803	0	3	6	0	9
7804	0	1	7	3	11
7805	0	4	10	0	14
7806	0	4	3	0	7
7807	0	4	3	3	10
7808	0	2	4	2	8
7809	0	6	5	1	12
7810	0	2	6	3	11
7811	0	0	8	1	9
7812	0	4	9	2	15
7813	0	6	6	3	15
7814	0	3	4	0	7
7815	0	3	3	2	8
7816	0	3	5	2	10
7817	0	3	1	1	5
7818	0	9	4	2	15
7819	0	2	6	1	9
7820	0	9	6	1	16
7821	0	2	0	5	7
7822	0	6	6	0	12
7823	0	5	7	3	15
7824	0	5	6	2	13
7825	0	6	7	4	17
7826	0	4	4	3	11
7827	0	4	7	1	12
7828	0	3	5	1	9
7829	0	6	3	0	9
7830	0	2	3	2	7
7831	0	5	5	0	10
7832	0	3	11	2	16
7833	0	4	6	1	11
7834	0	6	5	4	15
7835	0	3	0	3	6
7836	0	7	4	1	12
7837	0	3	4	2	9
7838	0	7	6	1	14
7839	0	3	1	2	6
7840	0	2	8	4	14
7841	0	6	9	0	15
7842	0	2	8	5	15
7843	0	4	11	1	16
7844	0	4	6	2	12
7845	0	0	4	1	5
7846	0	2	7	0	9
7847	0	3	7	3	13
7848	0	6	2	1	9
7849	0	4	5	1	10
7850	0	7	1	3	11
7851	0	8	5	1	14
7852	0	4	9	1	14
7853	0	4	2	0	6
7854	0	6	6	3	15
7855	0	4	4	1	9
7856	0	2	8	3	13
7857	0	4	5	3	12
7858	0	2	5	3	10
7859	0	6	1	2	9
7860	0	2	5	1	8
7861	0	7	7	0	14
7862	0	5	6	2	13
7863	0	7	4	0	11
7864	0	3	5	1	9
7865	0	4	4	4	12
7866	0	3	5	4	12
7867	0	4	9	1	14
7868	0	5	3	1	9
7869	0	5	1	1	7
7870	0	4	6	0	10
7871	0	1	8	2	11
7872	0	7	5	3	15
7873	0	2	2	3	7
7874	0	7	6	4	17
7875	0	4	9	3	16
7876	0	2	10	0	12
7877	0	5	5	4	14
7878	0	6	4	1	11
7879	0	5	6	1	12
7880	0	10	8	2	20
7881	0	5	6	1	12
7882	0	4	4	1	9
7883	0	3	8	0	11
7884	0	7	3	3	13
7885	0	3	3	1	7
7886	0	4	2	1	7
7887	0	9	1	2	12
7888	0	3	3	2	8
7889	0	3	7	1	11
7890	0	5	6	1	12
7891	0	4	10	1	15
7892	0	6	0	2	8
7893	0	3	9	0	12
7894	0	5	7	2	14
7895	0	3	8	4	15
7896	0	4	5	2	11
7897	0	4	5	1	10
7898	0	3	7	0	10
7899	0	3	2	0	5
7900	0	3	5	3	11
7901	0	0	5	3	8
7902	0	7	5	0	12
7903	0	3	4	1	8
7904	0	7	6	1	14
7905	0	2	9	0	11
7906	0	2	7	2	11
7907	0	4	1	3	8
7908	0	3	3	3	9
7909	0	3	6	0	9
7910	0	3	6	4	13
7911	0	2	5	0	7
7912	0	4	5	0	9
7913	0	4	5	1	10
7914	0	7	6	1	14
7915	0	4	3	2	9
7916	0	0	6	4	10
7917	0	4	3	4	11
7918	0	9	8	2	19
7919	0	4	1	1	6
7920	0	3	7	2	12
7921	0	7	3	5	15
7922	0	1	1	3	5
7923	0	3	4	3	10
7924	0	3	6	1	10
7925	0	3	7	0	10
7926	0	2	4	0	6
7927	0	7	8	0	15
7928	0	6	3	2	11
7929	0	2	5	1	8
7930	0	1	7	4	12
7931	0	5	8	0	13
7932	0	2	7	3	12
7933	0	5	5	2	12
7934	0	5	2	0	7
7935	0	5	8	3	16
7936	0	4	8	2	14
7937	0	7	6	0	13
7938	0	3	9	1	13
7939	0	2	9	4	15
7940	0	8	6	2	16
7941	0	0	3	2	5
7942	0	4	4	1	9
7943	0	3	6	0	9
7944	0	1	2	2	5
7945	0	4	8	4	16
7946	0	2	5	1	8
7947	0	2	8	2	12
7948	0	4	5	0	9
7949	0	1	3	3	7
7950	0	3	4	4	11
7951	0	6	2	0	8
7952	0	3	4	1	8
7953	0	3	5	1	9
7954	0	3	5	2	10
7955	0	6	3	4	13
7956	0	2	4	1	7
7957	0	2	4	2	8
7958	0	3	2	1	6
7959	0	4	5	1	10
7960	0	1	6	2	9
7961	0	3	5	0	8
7962	0	5	8	1	14
7963	0	6	5	2	13
7964	0	6	4	2	12
7965	0	4	3	1	8
7966	0	6	1	0	7
7967	0	6	5	2	13
7968	0	4	0	1	5
7969	0	5	5	1	11
7970	0	2	3	0	5
7971	0	4	7	2	13
7972	0	1	4	2	7
7973	0	6	6	2	14
7974	0	3	3	1	7
7975	0	3	2	2	7
7976	0	0	10	0	10
7977	0	8	8	1	17
7978	0	7	4	1	12
7979	0	5	5	0	10
7980	0	1	4	1	6
7981	0	4	8	0	12
7982	0	6	5	3	14
7983	0	7	2	1	10
7984	0	8	5	2	15
7985	0	6	5	2	13
7986	0	8	3	1	12
7987	0	1	5	1	7
7988	0	4	3	1	8
7989	0	4	6	1	11
7990	0	2	8	2	12
7991	0	5	2	0	7
7992	0	6	1	0	7
7993	0	3	9	0	12
7994	0	1	3	1	5
7995	0	7	5	1	13
7996	0	3	7	3	13
7997	0	4	9	0	13
7998	0	6	4	4	14
7999	0	4	4	1	9
8000	0	0	7	1	8
8001	0	9	4	1	14
8002	0	4	5	0	9
8003	0	1	2	2	5
8004	0	5	3	2	10
8005	0	1	4	1	6
8006	0	2	6	0	8
8007	0	3	3	4	10
8008	0	1	5	0	6
8009	0	3	3	0	6
8010	0	10	6	2	18
8011	0	1	1	0	2
8012	0	4	4	4	12
8013	0	1	5	1	7
8014	0	3	4	1	8
8015	0	6	4	1	11
8016	0	5	3	3	11
8017	0	5	3	1	9
8018	0	3	2	1	6
8019	0	2	5	3	10
8020	0	0	4	1	5
8021	0	4	8	1	13
8022	0	3	4	2	9
8023	0	3	4	2	9
8024	0	6	8	2	16
8025	0	1	6	2	9
8026	0	1	5	0	6
8027	0	3	1	1	5
8028	0	0	5	1	6
8029	0	2	4	3	9
8030	0	4	6	3	13
8031	0	2	3	0	5
8032	0	3	0	1	4
8033	0	3	4	1	8
8034	0	2	7	2	11
8035	0	2	3	2	7
8036	0	5	2	3	10
8037	0	3	3	3	9
8038	0	3	7	2	12
8039	0	4	4	3	11
8040	0	3	7	1	11
8041	0	3	7	4	14
8042	0	4	6	2	12
8043	0	5	7	0	12
8044	0	2	4	1	7
8045	0	2	1	1	4
8046	0	5	2	0	7
8047	0	1	7	1	9
8048	0	3	8	1	12
8049	0	4	1	0	5
8050	0	5	5	2	12
8051	0	3	2	2	7
8052	0	5	5	4	14
8053	0	4	5	1	10
8054	0	4	5	1	10
8055	0	4	4	2	10
8056	0	2	3	3	8
8057	0	3	6	1	10
8058	0	4	2	2	8
8059	0	6	3	3	12
8060	0	1	6	2	9
8061	0	0	7	1	8
8062	0	6	6	1	13
8063	0	4	6	0	10
8064	0	8	2	2	12
8065	0	5	7	0	12
8066	0	2	4	2	8
8067	0	2	9	0	11
8068	0	5	6	1	12
8069	0	4	5	1	10
8070	0	7	3	2	12
8071	0	2	5	1	8
8072	0	3	10	2	15
8073	0	4	1	5	10
8074	0	2	8	3	13
8075	0	4	4	2	10
8076	0	4	3	2	9
8077	0	1	3	4	8
8078	0	1	6	4	11
8079	0	2	7	0	9
8080	0	5	4	1	10
8081	0	1	4	1	6
8082	0	1	8	2	11
8083	0	2	3	0	5
8084	0	5	5	2	12
8085	0	6	3	2	11
8086	0	5	8	1	14
8087	0	4	6	2	12
8088	0	4	5	1	10
8089	0	7	6	1	14
8090	0	4	5	1	10
8091	0	5	5	5	15
8092	0	1	5	2	8
8093	0	5	2	0	7
8094	0	3	5	6	14
8095	0	6	6	1	13
8096	0	2	15	1	18
8097	0	2	4	2	8
8098	0	4	4	1	9
8099	0	5	3	2	10
8100	0	7	9	2	18
8101	0	4	2	0	6
8102	0	1	1	0	2
8103	0	3	7	2	12
8104	0	3	1	1	5
8105	0	1	4	4	9
8106	0	2	3	1	6
8107	0	4	3	2	9
8108	0	2	2	2	6
8109	0	8	6	1	15
8110	0	4	5	2	11
8111	0	4	2	0	6
8112	0	4	3	1	8
8113	0	0	5	0	5
8114	0	6	10	1	17
8115	0	5	1	3	9
8116	0	3	4	0	7
8117	0	3	3	0	6
8118	0	2	7	2	11
8119	0	7	4	2	13
8120	0	4	4	2	10
8121	0	4	2	0	6
8122	0	5	4	2	11
8123	0	5	7	1	13
8124	0	3	2	0	5
8125	0	7	7	1	15
8126	0	3	4	0	7
8127	0	3	7	1	11
8128	0	1	2	1	4
8129	0	3	2	1	6
8130	0	4	6	2	12
8131	0	3	4	1	8
8132	0	7	4	0	11
8133	0	2	5	1	8
8134	0	6	11	1	18
8135	0	2	6	1	9
8136	0	3	3	2	8
8137	0	3	3	0	6
8138	0	6	7	3	16
8139	0	3	4	3	10
8140	0	5	7	1	13
8141	0	3	4	1	8
8142	0	4	8	1	13
8143	0	1	11	1	13
8144	0	4	7	2	13
8145	0	4	2	3	9
8146	0	11	8	3	22
8147	0	3	6	2	11
8148	0	6	4	1	11
8149	0	3	5	1	9
8150	0	10	2	1	13
8151	0	4	9	3	16
8152	0	2	4	2	8
8153	0	3	3	1	7
8154	0	4	13	1	18
8155	0	3	5	1	9
8156	0	4	4	5	13
8157	0	5	3	3	11
8158	0	1	3	3	7
8159	0	1	5	1	7
8160	0	5	8	1	14
8161	0	1	6	0	7
8162	0	2	4	2	8
8163	0	2	9	1	12
8164	0	8	3	2	13
8165	0	3	3	0	6
8166	0	3	2	1	6
8167	0	4	1	1	6
8168	0	4	6	2	12
8169	0	3	4	1	8
8170	0	4	1	0	5
8171	0	4	2	0	6
8172	0	8	5	2	15
8173	0	1	5	0	6
8174	0	4	3	2	9
8175	0	3	4	0	7
8176	0	9	4	4	17
8177	0	4	4	1	9
8178	0	6	2	2	10
8179	0	3	5	1	9
8180	0	7	6	1	14
8181	0	4	8	1	13
8182	0	3	9	0	12
8183	0	3	4	0	7
8184	0	2	1	0	3
8185	0	4	5	1	10
8186	0	0	6	1	7
8187	0	2	3	1	6
8188	0	8	4	2	14
8189	0	1	1	1	3
8190	0	1	3	2	6
8191	0	4	7	0	11
8192	0	1	2	2	5
8193	0	4	4	1	9
8194	0	3	4	0	7
8195	0	4	4	2	10
8196	0	2	2	2	6
8197	0	1	6	0	7
8198	0	3	4	0	7
8199	0	4	3	2	9
8200	0	1	6	0	7
8201	0	4	5	1	10
8202	0	1	6	1	8
8203	0	7	1	3	11
8204	0	6	3	2	11
8205	0	1	4	1	6
8206	0	3	4	2	9
8207	0	4	4	2	10
8208	0	3	6	1	10
8209	0	4	4	2	10
8210	0	3	5	1	9
8211	0	3	3	2	8
8212	0	6	4	1	11
8213	0	4	1	2	7
8214	0	3	3	1	7
8215	0	5	2	0	7
8216	0	1	1	1	3
8217	0	1	1	0	2
8218	0	2	5	1	8
8219	0	2	7	1	10
8220	0	3	2	2	7
8221	0	2	4	4	10
8222	0	4	5	1	10
8223	0	4	10	2	16
8224	0	3	5	2	10
8225	0	1	4	0	5
8226	0	6	1	2	9
8227	0	5	4	2	11
8228	0	2	3	3	8
8229	0	4	4	1	9
8230	0	4	3	1	8
8231	0	7	2	4	13
8232	0	5	5	1	11
8233	0	2	2	1	5
8234	0	1	3	2	6
8235	0	6	5	1	12
8236	0	1	5	0	6
8237	0	4	6	2	12
8238	0	1	3	1	5
8239	0	4	1	1	6
8240	0	3	3	1	7
8241	0	5	7	1	13
8242	0	3	2	3	8
8243	0	2	6	2	10
8244	0	4	8	1	13
8245	0	2	4	2	8
8246	0	5	5	1	11
8247	0	2	6	3	11
8248	0	6	3	0	9
8249	0	3	5	1	9
8250	0	5	5	2	12
8251	0	3	3	0	6
8252	0	3	8	3	14
8253	0	6	7	1	14
8254	0	2	5	3	10
8255	0	3	6	2	11
8256	0	0	7	1	8
8257	0	4	5	0	9
8258	0	1	7	2	10
8259	0	5	3	0	8
8260	0	3	5	1	9
8261	0	3	6	1	10
8262	0	4	4	0	8
8263	0	4	4	2	10
8264	0	4	6	3	13
8265	0	1	4	0	5
8266	0	2	1	2	5
8267	0	3	4	2	9
8268	0	4	5	2	11
8269	0	4	4	1	9
8270	0	3	10	3	16
8271	0	4	4	3	11
8272	0	3	6	2	11
8273	0	1	4	2	7
8274	0	3	9	2	14
8275	0	4	6	1	11
8276	0	2	5	1	8
8277	0	3	1	1	5
8278	0	4	4	1	9
8279	0	2	4	1	7
8280	0	3	2	1	6
8281	0	2	2	2	6
8282	0	4	5	0	9
8283	0	1	3	2	6
8284	0	0	2	1	3
8285	0	1	2	3	6
8286	0	3	5	1	9
8287	0	1	3	1	5
8288	0	3	1	1	5
8289	0	6	3	2	11
8290	0	3	4	0	7
8291	0	5	5	5	15
8292	0	3	5	3	11
8293	0	1	3	4	8
8294	0	4	0	0	4
8295	0	4	4	1	9
8296	0	4	7	3	14
8297	0	1	5	2	8
8298	0	3	2	1	6
8299	0	0	1	1	2
8300	0	1	7	0	8
8301	0	4	1	0	5
8302	0	4	7	3	14
8303	0	4	6	0	10
8304	0	1	8	2	11
8305	0	2	6	1	9
8306	0	4	3	0	7
8307	0	3	6	2	11
8308	0	3	2	1	6
8309	0	3	5	3	11
8310	0	5	3	3	11
8311	0	7	4	1	12
8312	0	3	4	2	9
8313	0	4	5	3	12
8314	0	5	2	2	9
8315	0	1	4	2	7
8316	0	2	6	0	8
8317	0	5	9	1	15
8318	0	2	3	0	5
8319	0	2	2	0	4
8320	0	4	4	1	9
8321	0	2	5	0	7
8322	0	3	4	0	7
8323	0	5	1	4	10
8324	0	6	5	4	15
8325	0	1	7	2	10
8326	0	4	1	2	7
8327	0	2	4	3	9
8328	0	2	1	0	3
8329	0	3	3	0	6
8330	0	4	1	0	5
8331	0	5	3	3	11
8332	0	2	2	2	6
8333	0	4	6	3	13
8334	0	6	4	5	15
8335	0	2	4	1	7
8336	0	3	4	2	9
8337	0	4	4	1	9
8338	0	2	5	2	9
8339	0	3	6	0	9
8340	0	1	4	2	7
8341	0	2	2	1	5
8342	0	2	8	0	10
8343	0	1	0	3	4
8344	0	2	2	0	4
8345	0	1	5	2	8
8346	0	4	5	4	13
8347	0	1	2	3	6
8348	0	5	1	1	7
8349	0	3	7	0	10
8350	0	3	7	1	11
8351	0	1	5	1	7
8352	0	3	4	1	8
8353	0	5	1	1	7
8354	0	3	6	0	9
8355	0	4	6	0	10
8356	0	0	4	3	7
8357	0	6	0	0	6
8358	0	5	2	3	10
8359	0	2	2	1	5
8360	0	0	3	1	4
8361	0	1	4	1	6
8362	0	6	2	4	12
8363	0	4	4	2	10
8364	0	5	3	1	9
8365	0	1	6	1	8
8366	0	2	4	2	8
8367	0	6	4	4	14
8368	0	3	5	1	9
8369	0	4	2	1	7
8370	0	4	2	2	8
8371	0	4	2	1	7
8372	0	4	4	0	8
8373	0	3	4	1	8
8374	0	5	5	1	11
8375	0	3	7	1	11
8376	0	2	6	1	9
8377	0	0	2	1	3
8378	0	7	3	4	14
8379	0	1	5	1	7
8380	0	3	5	0	8
8381	0	2	4	2	8
8382	0	3	6	1	10
8383	0	2	1	1	4
8384	0	2	4	1	7
8385	0	3	2	2	7
8386	0	6	3	1	10
8387	0	1	4	0	5
8388	0	3	3	2	8
8389	0	2	1	0	3
8390	0	1	3	2	6
8391	0	0	2	1	3
8392	0	3	4	2	9
8393	0	1	6	0	7
8394	0	3	1	2	6
8395	0	5	3	1	9
8396	0	3	1	1	5
8397	0	2	4	0	6
8398	0	5	5	1	11
8399	0	4	4	2	10
8400	0	1	7	0	8
8401	0	0	5	1	6
8402	0	2	7	1	10
8403	0	9	5	2	16
8404	0	7	3	2	12
8405	0	4	2	4	10
8406	0	2	3	3	8
8407	0	6	3	3	12
8408	0	6	4	0	10
8409	0	3	7	1	11
8410	0	6	2	4	12
8411	0	2	7	0	9
8412	0	2	1	1	4
8413	0	3	1	0	4
8414	0	5	4	0	9
8415	0	6	6	2	14
8416	0	3	4	3	10
8417	0	0	4	0	4
8418	0	6	5	1	12
8419	0	1	2	2	5
8420	0	3	7	0	10
8421	0	5	4	1	10
8422	0	3	2	2	7
8423	0	5	3	0	8
8424	0	1	3	2	6
8425	0	1	2	2	5
8426	0	4	4	3	11
8427	0	2	3	3	8
8428	0	3	6	2	11
8429	0	1	2	1	4
8430	0	3	5	2	10
8431	0	3	7	1	11
8432	0	3	2	1	6
8433	0	4	2	0	6
8434	0	4	3	1	8
8435	0	2	1	3	6
8436	0	2	2	2	6
8437	0	4	3	1	8
8438	0	1	1	0	2
8439	0	5	7	3	15
8440	0	4	7	2	13
8441	0	0	5	1	6
8442	0	3	6	0	9
8443	0	4	5	4	13
8444	0	0	1	1	2
8445	0	5	3	2	10
8446	0	3	5	0	8
8447	0	4	2	2	8
8448	0	3	2	2	7
8449	0	2	7	1	10
8450	0	1	5	1	7
8451	0	0	5	0	5
8452	0	3	1	2	6
8453	0	3	5	2	10
8454	0	5	4	1	10
8455	0	6	1	2	9
8456	0	5	7	0	12
8457	0	3	5	1	9
8458	0	1	4	1	6
8459	0	4	2	0	6
8460	0	1	4	1	6
8461	0	1	4	2	7
8462	0	2	2	1	5
8463	0	4	4	1	9
8464	0	3	3	3	9
8465	0	2	1	1	4
8466	0	2	4	3	9
8467	0	4	3	0	7
8468	0	0	7	0	7
8469	0	3	0	3	6
8470	0	2	2	1	5
8471	0	2	2	1	5
8472	0	0	3	1	4
8473	0	3	4	1	8
8474	0	4	2	2	8
8475	0	6	5	0	11
8476	0	5	4	1	10
8477	0	5	3	0	8
8478	0	4	3	1	8
8479	0	0	3	0	3
8480	0	3	4	1	8
8481	0	4	5	1	10
8482	0	8	1	2	11
8483	0	3	6	1	10
8484	0	1	3	0	4
8485	0	2	4	3	9
8486	0	6	4	0	10
8487	0	3	6	1	10
8488	0	3	4	2	9
8489	0	3	2	1	6
8490	0	7	1	3	11
8491	0	3	7	1	11
8492	0	2	5	0	7
8493	0	2	3	1	6
8494	0	5	3	1	9
8495	0	3	4	0	7
8496	0	3	6	3	12
8497	0	2	3	3	8
8498	0	0	3	2	5
8499	0	0	3	4	7
8500	0	1	6	2	9
8501	0	2	7	2	11
8502	0	1	3	2	6
8503	0	1	12	1	14
8504	0	1	2	0	3
8505	0	1	4	3	8
8506	0	5	2	2	9
8507	0	3	4	0	7
8508	0	2	3	2	7
8509	0	4	6	2	12
8510	0	3	9	1	13
8511	0	4	5	1	10
8512	0	2	3	0	5
8513	0	6	6	0	12
8514	0	5	3	2	10
8515	0	6	2	1	9
8516	0	1	4	1	6
8517	0	4	2	0	6
8518	0	3	4	2	9
8519	0	3	5	0	8
8520	0	0	4	1	5
8521	0	1	1	0	2
8522	0	4	0	2	6
8523	0	3	4	3	10
8524	0	6	3	0	9
8525	0	2	4	0	6
8526	0	7	3	1	11
8527	0	3	6	0	9
8528	0	5	4	1	10
8529	0	5	6	1	12
8530	0	2	2	1	5
8531	0	5	3	0	8
8532	0	4	5	1	10
8533	0	2	2	3	7
8534	0	2	3	0	5
8535	0	5	3	3	11
8536	0	2	3	1	6
8537	0	3	0	0	3
8538	0	1	4	0	5
8539	0	2	7	0	9
8540	0	3	1	2	6
8541	0	3	2	1	6
8542	0	3	2	0	5
8543	0	0	3	0	3
8544	0	2	4	0	6
8545	0	3	3	4	10
8546	0	4	1	2	7
8547	0	5	2	1	8
8548	0	3	2	0	5
8549	0	2	3	1	6
8550	0	2	6	0	8
8551	0	2	1	2	5
8552	0	2	3	0	5
8553	0	2	3	0	5
8554	0	5	6	3	14
8555	0	1	2	4	7
8556	0	1	7	2	10
8557	0	2	6	1	9
8558	0	5	3	2	10
8559	0	3	2	4	9
8560	0	3	5	2	10
8561	0	3	4	1	8
8562	0	6	1	3	10
8563	0	3	3	1	7
8564	0	3	7	0	10
8565	0	3	4	2	9
8566	0	8	4	1	13
8567	0	6	3	1	10
8568	0	3	3	0	6
8569	0	1	3	0	4
8570	0	3	4	1	8
8571	0	3	6	2	11
8572	0	3	2	1	6
8573	0	1	8	1	10
8574	0	4	6	1	11
8575	0	4	2	0	6
8576	0	2	3	1	6
8577	0	3	6	1	10
8578	0	2	2	3	7
8579	0	4	7	2	13
8580	0	4	3	1	8
8581	0	2	3	3	8
8582	0	3	2	1	6
8583	0	1	1	1	3
8584	0	1	4	4	9
8585	0	6	3	0	9
8586	0	5	2	2	9
8587	0	1	1	0	2
8588	0	4	4	2	10
8589	0	3	6	0	9
8590	0	1	6	0	7
8591	0	5	2	1	8
8592	0	3	1	3	7
8593	0	2	3	0	5
8594	0	3	4	2	9
8595	0	5	3	1	9
8596	0	5	8	0	13
8597	0	3	1	1	5
8598	0	0	1	0	1
8599	0	4	7	2	13
8600	0	2	2	0	4
8601	0	2	5	0	7
8602	0	1	0	0	1
8603	0	2	7	2	11
8604	0	5	2	2	9
8605	0	2	2	0	4
8606	0	4	2	1	7
8607	0	1	6	0	7
8608	0	4	4	1	9
8609	0	2	6	1	9
8610	0	0	6	1	7
8611	0	1	3	4	8
8612	0	4	1	2	7
8613	0	2	2	0	4
8614	0	1	4	3	8
8615	0	4	3	1	8
8616	0	2	4	3	9
8617	0	2	7	2	11
8618	0	2	3	0	5
8619	0	1	7	0	8
8620	0	2	3	2	7
8621	0	3	2	0	5
8622	0	1	2	1	4
8623	0	3	7	0	10
8624	0	4	2	0	6
8625	0	3	4	0	7
8626	0	2	3	0	5
8627	0	1	4	4	9
8628	0	2	3	2	7
8629	0	3	3	1	7
8630	0	4	3	0	7
8631	0	6	3	0	9
8632	0	3	2	0	5
8633	0	2	3	0	5
8634	0	3	4	1	8
8635	0	2	3	1	6
8636	0	0	2	2	4
8637	0	2	1	1	4
8638	0	4	2	2	8
8639	0	2	4	2	8
8640	0	2	5	1	8
8641	0	3	0	2	5
8642	0	0	4	2	6
8643	0	2	2	0	4
8644	0	2	4	1	7
8645	0	1	5	2	8
8646	0	6	3	1	10
8647	0	2	3	1	6
8648	0	3	3	1	7
8649	0	2	1	1	4
8650	0	2	3	0	5
8651	0	2	5	0	7
8652	0	4	1	1	6
8653	0	2	3	1	6
8654	0	4	1	0	5
8655	0	2	3	0	5
8656	0	1	3	2	6
8657	0	2	2	2	6
8658	0	4	3	1	8
8659	0	0	5	1	6
8660	0	1	2	3	6
8661	0	3	2	0	5
8662	0	4	4	1	9
8663	0	0	4	0	4
8664	0	3	4	2	9
8665	0	1	1	1	3
8666	0	4	3	0	7
8667	0	3	4	0	7
8668	0	6	1	0	7
8669	0	2	2	1	5
8670	0	2	2	1	5
8671	0	2	4	1	7
8672	0	4	2	0	6
8673	0	2	0	1	3
8674	0	1	2	1	4
8675	0	3	6	1	10
8676	0	0	4	0	4
8677	0	3	6	1	10
8678	0	4	6	0	10
8679	0	3	4	3	10
8680	0	3	5	0	8
8681	0	2	2	1	5
8682	0	2	2	2	6
8683	0	4	2	1	7
8684	0	1	4	2	7
8685	0	6	7	1	14
8686	0	2	4	1	7
8687	0	1	7	1	9
8688	0	1	1	1	3
8689	0	6	2	0	8
8690	0	2	8	0	10
8691	0	6	3	1	10
8692	0	3	3	2	8
8693	0	1	2	2	5
8694	0	3	6	0	9
8695	0	0	3	1	4
8696	0	4	6	3	13
8697	0	1	8	0	9
8698	0	3	2	0	5
8699	0	1	7	1	9
8700	0	4	1	2	7
8701	0	1	2	0	3
8702	0	3	1	0	4
8703	0	3	2	0	5
8704	0	3	7	1	11
8705	0	2	4	2	8
8706	0	5	6	2	13
8707	0	2	2	1	5
8708	0	3	4	1	8
8709	0	3	4	2	9
8710	0	1	4	1	6
8711	0	2	6	1	9
8712	0	5	3	2	10
8713	0	4	2	1	7
8714	0	3	4	1	8
8715	0	4	5	1	10
8716	0	0	4	1	5
8717	0	2	3	0	5
8718	0	4	2	0	6
8719	0	1	2	0	3
8720	0	3	2	1	6
8721	0	1	3	2	6
8722	0	2	3	2	7
8723	0	3	3	1	7
8724	0	3	2	2	7
8725	0	6	3	1	10
8726	0	2	2	2	6
8727	0	3	3	1	7
8728	0	1	7	2	10
8729	0	4	3	1	8
8730	0	4	3	2	9
8731	0	1	1	0	2
8732	0	1	4	1	6
8733	0	2	6	1	9
8734	0	2	3	0	5
8735	0	4	2	1	7
8736	0	1	2	1	4
8737	0	5	5	0	10
8738	0	3	5	0	8
8739	0	2	3	1	6
8740	0	3	2	2	7
8741	0	1	4	1	6
8742	0	4	4	0	8
8743	0	2	5	1	8
8744	0	2	6	1	9
8745	0	2	3	0	5
8746	0	2	3	1	6
8747	0	4	3	2	9
8748	0	6	8	1	15
8749	0	2	3	1	6
8750	0	1	7	2	10
8751	0	1	2	1	4
8752	0	2	2	1	5
8753	0	4	5	0	9
8754	0	3	4	0	7
8755	0	4	2	2	8
8756	0	1	1	2	4
8757	0	1	2	1	4
8758	0	0	4	1	5
8759	0	5	3	2	10
8760	0	1	2	2	5
8761	0	2	1	0	3
8762	0	2	5	2	9
8763	0	6	1	2	9
8764	0	6	3	2	11
8765	0	5	5	0	10
8766	0	3	4	2	9
8767	0	2	3	0	5
8768	0	4	4	0	8
8769	0	4	0	1	5
8770	0	3	4	2	9
8771	0	2	5	3	10
8772	0	3	2	0	5
8773	0	2	4	3	9
8774	0	0	1	0	1
8775	0	5	5	1	11
8776	0	4	14	2	20
8777	0	1	3	1	5
8778	0	1	6	0	7
8779	0	4	8	0	12
8780	0	2	3	2	7
8781	0	1	3	1	5
8782	0	1	1	2	4
8783	0	2	2	1	5
8784	0	1	3	0	4
8785	0	2	5	1	8
8786	0	5	4	0	9
8787	0	3	7	1	11
8788	0	2	1	0	3
8789	0	2	2	2	6
8790	0	4	6	0	10
8791	0	3	0	0	3
8792	0	3	2	2	7
8793	0	1	1	2	4
8794	0	1	4	0	5
8795	0	1	3	0	4
8796	0	0	2	1	3
8797	0	4	5	2	11
8798	0	5	3	0	8
8799	0	1	2	2	5
8800	0	3	2	3	8
8801	0	3	4	1	8
8802	0	2	3	1	6
8803	0	2	7	4	13
8804	0	0	2	1	3
8805	0	4	3	2	9
8806	0	4	3	0	7
8807	0	2	3	1	6
8808	0	3	2	1	6
8809	0	5	6	3	14
8810	0	2	2	1	5
8811	0	1	4	1	6
8812	0	3	7	0	10
8813	0	2	5	0	7
8814	0	0	4	1	5
8815	0	2	2	1	5
8816	0	1	8	1	10
8817	0	2	3	0	5
8818	0	4	1	5	10
8819	0	3	2	0	5
8820	0	2	2	0	4
8821	0	5	5	1	11
8822	0	2	3	1	6
8823	0	3	2	2	7
8824	0	3	6	0	9
8825	0	8	2	2	12
8826	0	0	7	0	7
8827	0	0	2	0	2
8828	0	1	6	0	7
8829	0	5	5	3	13
8830	0	0	2	2	4
8831	0	2	4	0	6
8832	0	2	5	0	7
8833	0	2	4	1	7
8834	0	3	1	2	6
8835	0	2	5	1	8
8836	0	2	0	0	2
8837	0	3	3	0	6
8838	0	1	3	0	4
8839	0	4	6	0	10
8840	0	2	3	0	5
8841	0	4	4	1	9
8842	0	1	4	0	5
8843	0	1	2	2	5
8844	0	4	1	1	6
8845	0	4	3	2	9
8846	0	4	2	0	6
8847	0	3	3	2	8
8848	0	1	3	0	4
8849	0	3	3	1	7
8850	0	3	3	2	8
8851	0	2	9	1	12
8852	0	3	1	1	5
8853	0	1	2	1	4
8854	0	4	1	1	6
8855	0	2	3	1	6
8856	0	1	3	0	4
8857	0	2	1	1	4
8858	0	3	7	2	12
8859	0	4	3	1	8
8860	0	4	4	0	8
8861	0	4	1	2	7
8862	0	2	5	0	7
8863	0	0	1	0	1
8864	0	2	3	3	8
8865	0	1	1	0	2
8866	0	4	2	1	7
8867	0	2	1	1	4
8868	0	0	3	1	4
8869	0	4	2	0	6
8870	0	0	2	4	6
8871	0	3	4	1	8
8872	0	1	3	2	6
8873	0	1	0	0	1
8874	0	4	3	1	8
8875	0	1	1	2	4
8876	0	1	4	1	6
8877	0	2	1	2	5
8878	0	4	4	1	9
8879	0	1	2	1	4
8880	0	2	2	0	4
8881	0	0	5	1	6
8882	0	4	3	0	7
8883	0	1	3	0	4
8884	0	1	4	2	7
8885	0	4	3	1	8
8886	0	1	4	0	5
8887	0	3	1	0	4
8888	0	5	6	0	11
8889	0	3	4	1	8
8890	0	2	2	4	8
8891	0	3	3	2	8
8892	0	2	2	2	6
8893	0	3	2	1	6
8894	0	4	5	0	9
8895	0	0	3	1	4
8896	0	5	4	0	9
8897	0	2	3	1	6
8898	0	3	1	3	7
8899	0	1	3	2	6
8900	0	2	3	2	7
8901	0	3	1	0	4
8902	0	2	7	2	11
8903	0	3	2	2	7
8904	0	0	4	2	6
8905	0	3	1	1	5
8906	0	2	8	1	11
8907	0	2	4	2	8
8908	0	4	1	2	7
8909	0	2	5	4	11
8910	0	2	6	1	9
8911	0	2	5	0	7
8912	0	1	6	0	7
8913	0	4	2	2	8
8914	0	4	1	1	6
8915	0	3	1	1	5
8916	0	3	4	0	7
8917	0	1	3	1	5
8918	0	0	2	2	4
8919	0	1	4	2	7
8920	0	3	6	1	10
8921	0	0	4	0	4
8922	0	2	2	1	5
8923	0	3	5	1	9
8924	0	2	2	1	5
8925	0	3	2	1	6
8926	0	1	5	0	6
8927	0	6	5	1	12
8928	0	1	3	1	5
8929	0	2	1	0	3
8930	0	2	2	1	5
8931	0	2	3	0	5
8932	0	2	3	1	6
8933	0	1	2	2	5
8934	0	3	2	0	5
8935	0	5	5	1	11
8936	0	5	1	2	8
8937	0	2	2	1	5
8938	0	3	2	1	6
8939	0	5	3	2	10
8940	0	2	2	2	6
8941	0	1	3	0	4
8942	0	3	5	0	8
8943	0	3	5	0	8
8944	0	1	5	0	6
8945	0	2	6	0	8
8946	0	3	3	1	7
8947	0	2	4	0	6
8948	0	1	6	1	8
8949	0	5	1	2	8
8950	0	1	2	2	5
8951	0	2	3	0	5
8952	0	5	0	0	5
8953	0	6	4	0	10
8954	0	3	1	3	7
8955	0	3	2	0	5
8956	0	6	0	1	7
8957	0	4	3	1	8
8958	0	3	0	0	3
8959	0	1	7	2	10
8960	0	2	2	0	4
8961	0	0	5	1	6
8962	0	6	2	1	9
8963	0	1	4	0	5
8964	0	4	7	2	13
8965	0	2	4	1	7
8966	0	1	1	1	3
8967	0	3	1	2	6
8968	0	2	3	0	5
8969	0	1	5	0	6
8970	0	1	3	1	5
8971	0	1	5	0	6
8972	0	3	1	2	6
8973	0	1	2	0	3
8974	0	1	4	0	5
8975	0	3	2	0	5
8976	0	2	2	2	6
8977	0	3	4	1	8
8978	0	4	1	0	5
8979	0	2	4	2	8
8980	0	4	6	1	11
8981	0	1	4	2	7
8982	0	5	2	0	7
8983	0	1	1	1	3
8984	0	3	2	0	5
8985	0	3	6	0	9
8986	0	2	7	1	10
8987	0	6	1	0	7
8988	0	3	3	0	6
8989	0	1	3	1	5
8990	0	1	5	0	6
8991	0	6	4	1	11
8992	0	3	3	1	7
8993	0	2	1	2	5
8994	0	1	6	0	7
8995	0	1	2	1	4
8996	0	1	5	1	7
8997	0	2	1	0	3
8998	0	5	1	3	9
8999	0	1	3	0	4
9000	0	4	2	2	8
9001	0	3	3	1	7
9002	0	0	2	0	2
9003	0	0	4	1	5
9004	0	3	5	0	8
9005	0	1	7	1	9
9006	0	0	2	0	2
9007	0	6	4	0	10
9008	0	1	2	1	4
9009	0	1	5	1	7
9010	0	2	3	0	5
9011	0	2	5	1	8
9012	0	3	2	2	7
9013	0	5	1	2	8
9014	0	0	8	0	8
9015	0	4	4	0	8
9016	0	4	1	0	5
9017	0	3	1	0	4
9018	0	3	5	1	9
9019	0	3	3	2	8
9020	0	3	4	1	8
9021	0	1	8	0	9
9022	0	4	4	2	10
9023	0	2	4	0	6
9024	0	2	2	0	4
9025	0	0	1	1	2
9026	0	2	3	2	7
9027	0	1	3	2	6
9028	0	2	1	0	3
9029	0	5	2	0	7
9030	0	1	5	2	8
9031	0	2	2	1	5
9032	0	2	5	1	8
9033	0	3	2	2	7
9034	0	2	4	0	6
9035	0	3	3	1	7
9036	0	3	6	2	11
9037	0	1	2	1	4
9038	0	2	1	0	3
9039	0	1	1	0	2
9040	0	2	6	3	11
9041	0	1	0	1	2
9042	0	2	1	0	3
9043	0	6	4	0	10
9044	0	1	1	0	2
9045	0	2	1	0	3
9046	0	4	5	1	10
9047	0	4	3	0	7
9048	0	3	1	3	7
9049	0	6	4	1	11
9050	0	2	3	0	5
9051	0	3	0	1	4
9052	0	0	3	2	5
9053	0	2	1	1	4
9054	0	1	3	2	6
9055	0	0	0	1	1
9056	0	2	1	1	4
9057	0	3	2	1	6
9058	0	3	3	3	9
9059	0	2	3	0	5
9060	0	3	3	3	9
9061	0	3	4	4	11
9062	0	3	7	4	14
9063	0	4	1	0	5
9064	0	3	5	2	10
9065	0	4	1	3	8
9066	0	3	0	2	5
9067	0	2	0	1	3
9068	0	0	5	1	6
9069	0	2	1	1	4
9070	0	4	3	1	8
9071	0	1	2	0	3
9072	0	2	3	0	5
9073	0	3	5	2	10
9074	0	3	8	0	11
9075	0	0	3	2	5
9076	0	5	5	1	11
9077	0	2	2	1	5
9078	0	2	4	0	6
9079	0	2	1	1	4
9080	0	3	4	2	9
9081	0	0	3	0	3
9082	0	3	4	1	8
9083	0	1	1	0	2
9084	0	2	0	2	4
9085	0	2	7	3	12
9086	0	3	5	0	8
9087	0	3	1	0	4
9088	0	0	3	0	3
9089	0	1	0	1	2
9090	0	2	2	0	4
9091	0	2	4	1	7
9092	0	3	3	1	7
9093	0	3	0	2	5
9094	0	0	7	1	8
9095	0	3	3	2	8
9096	0	1	3	1	5
9097	0	4	1	3	8
9098	0	2	3	1	6
9099	0	2	5	1	8
9100	0	2	4	0	6
9101	0	1	2	1	4
9102	0	1	1	0	2
9103	0	1	2	0	3
9104	0	6	2	1	9
9105	0	4	2	1	7
9106	0	3	3	0	6
9107	0	0	4	0	4
9108	0	2	3	1	6
9109	0	5	3	1	9
9110	0	2	7	0	9
9111	0	2	3	1	6
9112	0	1	2	0	3
9113	0	4	8	1	13
9114	0	4	5	0	9
9115	0	0	2	1	3
9116	0	2	4	1	7
9117	0	6	6	0	12
9118	0	2	1	3	6
9119	0	2	1	1	4
9120	0	3	1	1	5
9121	0	0	0	1	1
9122	0	1	4	1	6
9123	0	2	2	0	4
9124	0	4	2	0	6
9125	0	2	3	2	7
9126	0	3	2	0	5
9127	0	3	8	2	13
9128	0	1	1	1	3
9129	0	3	3	0	6
9130	0	3	4	0	7
9131	0	1	0	0	1
9132	0	1	2	2	5
9133	0	2	0	1	3
9134	0	3	1	1	5
9135	0	3	1	0	4
9136	0	0	2	2	4
9137	0	2	1	1	4
9138	0	2	1	1	4
9139	0	0	2	1	3
9140	0	3	2	2	7
9141	0	3	4	2	9
9142	0	3	3	0	6
9143	0	1	4	3	8
9144	0	1	1	0	2
9145	0	2	4	0	6
9146	0	1	4	2	7
9147	0	5	1	3	9
9148	0	0	1	2	3
9149	0	2	2	1	5
9150	0	3	2	1	6
9151	0	1	3	1	5
9152	0	4	0	2	6
9153	0	3	3	0	6
9154	0	0	1	1	2
9155	0	0	1	2	3
9157	0	3	2	0	5
9158	0	2	2	0	4
9159	0	0	3	1	4
9160	0	2	3	0	5
9161	0	4	1	0	5
9162	0	1	3	0	4
9163	0	2	2	1	5
9164	0	6	4	0	10
9165	0	2	0	0	2
9166	0	3	6	2	11
9167	0	4	2	0	6
9168	0	2	1	1	4
9169	0	4	4	2	10
9170	0	6	2	1	9
9171	0	0	2	2	4
9172	0	4	1	1	6
9173	0	0	1	0	1
9174	0	0	5	1	6
9175	0	1	4	0	5
9176	0	3	1	3	7
9177	0	1	2	1	4
9178	0	2	1	2	5
9179	0	4	2	1	7
9180	0	5	3	1	9
9181	0	3	1	1	5
9182	0	2	3	2	7
9183	0	3	5	1	9
9184	0	3	1	0	4
9185	0	1	3	0	4
9186	0	4	2	1	7
9187	0	3	0	1	4
9188	0	0	3	1	4
9189	0	2	7	0	9
9190	0	1	2	1	4
9191	0	4	4	3	11
9192	0	1	4	1	6
9193	0	0	4	0	4
9194	0	4	0	2	6
9195	0	3	3	1	7
9196	0	4	2	2	8
9197	0	2	4	1	7
9198	0	3	6	3	12
9199	0	0	1	0	1
9200	0	2	2	1	5
9201	0	0	3	0	3
9202	0	4	1	1	6
9203	0	0	3	2	5
9204	0	3	2	0	5
9205	0	3	4	0	7
9206	0	2	3	1	6
9207	0	4	1	1	6
9208	0	3	2	2	7
9209	0	3	2	1	6
9210	0	2	4	1	7
9211	0	5	4	2	11
9212	0	1	6	1	8
9213	0	1	5	0	6
9214	0	2	6	0	8
9215	0	1	3	1	5
9216	0	3	3	1	7
9217	0	2	4	0	6
9218	0	1	3	0	4
9219	0	1	5	0	6
9220	0	2	2	1	5
9221	0	1	1	1	3
9222	0	3	2	3	8
9223	0	0	1	1	2
9224	0	2	1	1	4
9225	0	2	1	0	3
9226	0	2	4	1	7
9227	0	4	4	0	8
9228	0	5	2	0	7
9229	0	3	1	2	6
9230	0	0	1	1	2
9231	0	1	2	1	4
9232	0	2	1	0	3
9233	0	4	1	2	7
9234	0	1	1	0	2
9235	0	1	2	1	4
9236	0	3	4	1	8
9237	0	2	5	0	7
9238	0	1	2	0	3
9239	0	1	2	0	3
9240	0	2	2	0	4
9241	0	3	3	0	6
9242	0	7	1	0	8
9243	0	4	3	0	7
9244	0	2	1	1	4
9245	0	2	4	1	7
9246	0	1	3	1	5
9247	0	3	1	1	5
9248	0	2	1	0	3
9249	0	0	7	1	8
9250	0	3	3	0	6
9251	0	0	5	2	7
9252	0	1	1	1	3
9253	0	3	3	1	7
9254	0	1	1	2	4
9255	0	4	1	2	7
9256	0	4	5	3	12
9257	0	1	2	1	4
9258	0	4	0	1	5
9259	0	3	2	0	5
9260	0	2	5	2	9
9261	0	2	4	0	6
9262	0	3	2	1	6
9263	0	2	2	1	5
9264	0	6	1	2	9
9265	0	0	4	1	5
9266	0	3	3	3	9
9267	0	3	2	1	6
9268	0	2	1	0	3
9269	0	2	4	2	8
9270	0	1	4	0	5
9271	0	6	0	3	9
9272	0	3	2	1	6
9273	0	2	4	0	6
9274	0	3	5	1	9
9275	0	2	3	2	7
9276	0	4	1	0	5
9277	0	3	3	1	7
9278	0	2	1	0	3
9279	0	3	5	0	8
9280	0	1	1	0	2
9281	0	0	4	0	4
9282	0	5	2	0	7
9283	0	2	3	1	6
9284	0	3	2	0	5
9285	0	3	5	2	10
9286	0	2	2	1	5
9287	0	0	3	2	5
9288	0	3	2	0	5
9289	0	2	2	1	5
9290	0	2	2	0	4
9291	0	2	0	1	3
9292	0	1	1	1	3
9293	0	0	3	1	4
9294	0	3	3	0	6
9295	0	2	1	0	3
9296	0	4	1	0	5
9297	0	2	0	2	4
9298	0	1	0	0	1
9299	0	1	3	0	4
9300	0	2	4	0	6
9301	0	3	4	0	7
9302	0	3	4	0	7
9303	0	5	1	1	7
9304	0	2	5	0	7
9305	0	2	6	3	11
9306	0	0	3	2	5
9307	0	0	4	0	4
9308	0	2	4	1	7
9309	0	4	0	1	5
9310	0	2	5	1	8
9311	0	0	6	0	6
9312	0	3	3	0	6
9313	0	2	3	0	5
9314	0	1	3	0	4
9315	0	2	5	1	8
9316	0	2	2	0	4
9317	0	0	3	1	4
9318	0	2	6	1	9
9319	0	1	2	1	4
9320	0	3	2	3	8
9321	0	2	5	0	7
9322	0	1	4	0	5
9323	0	4	2	1	7
9324	0	4	4	1	9
9325	0	2	1	0	3
9326	0	0	2	0	2
9327	0	2	2	1	5
9328	0	2	2	0	4
9329	0	4	6	0	10
9330	0	4	1	2	7
9331	0	4	0	0	4
9332	0	1	3	0	4
9333	0	2	2	1	5
9334	0	2	3	1	6
9335	0	3	2	0	5
9336	0	2	7	1	10
9337	0	3	3	1	7
9338	0	0	1	0	1
9339	0	0	2	1	3
9340	0	3	3	0	6
9341	0	1	4	0	5
9342	0	6	4	0	10
9343	0	4	5	1	10
9344	0	1	2	0	3
9345	0	1	2	2	5
9346	0	2	6	0	8
9347	0	3	1	1	5
9348	0	3	3	2	8
9349	0	1	3	0	4
9350	0	2	1	2	5
9351	0	2	3	0	5
9352	0	3	3	1	7
9353	0	3	1	0	4
9354	0	4	2	0	6
9355	0	1	2	0	3
9356	0	5	1	1	7
9357	0	2	1	1	4
9358	0	4	2	2	8
9359	0	4	4	1	9
9360	0	1	6	1	8
9361	0	3	1	0	4
9362	0	3	4	0	7
9363	0	3	3	3	9
9364	0	2	3	1	6
9365	0	3	0	1	4
9366	0	1	1	1	3
9367	0	2	0	0	2
9368	0	3	2	0	5
9369	0	2	4	2	8
9371	0	2	1	1	4
9372	0	3	6	0	9
9373	0	3	2	1	6
9374	0	3	3	2	8
9375	0	2	4	1	7
9376	0	1	4	1	6
9377	0	2	6	1	9
9378	0	3	1	2	6
9379	0	2	5	0	7
9380	0	1	1	0	2
9381	0	1	1	1	3
9382	0	3	4	1	8
9383	0	4	3	0	7
9384	0	3	5	0	8
9385	0	2	2	1	5
9386	0	3	3	1	7
9387	0	1	2	0	3
9388	0	2	4	1	7
9389	0	2	2	1	5
9390	0	1	3	1	5
9391	0	1	1	0	2
9392	0	1	3	1	5
9393	0	1	2	0	3
9394	0	2	3	1	6
9395	0	1	2	2	5
9396	0	1	3	1	5
9397	0	2	1	1	4
9398	0	3	2	2	7
9399	0	3	3	0	6
9400	0	4	3	1	8
9401	0	1	4	1	6
9402	0	4	2	1	7
9403	0	3	4	2	9
9404	0	0	4	0	4
9405	0	4	1	1	6
9406	0	3	1	1	5
9407	0	5	5	2	12
9408	0	4	6	0	10
9409	0	2	2	0	4
9410	0	2	1	1	4
9411	0	2	1	2	5
9412	0	0	6	1	7
9413	0	1	4	2	7
9414	0	1	4	0	5
9415	0	2	2	0	4
9416	0	2	6	0	8
9417	0	1	5	1	7
9418	0	5	4	0	9
9419	0	0	7	0	7
9420	0	1	3	1	5
9421	0	1	4	2	7
9422	0	1	2	0	3
9423	0	1	1	0	2
9424	0	5	2	0	7
9425	0	2	3	1	6
9426	0	1	3	0	4
9427	0	4	4	1	9
9428	0	0	2	2	4
9429	0	1	3	1	5
9430	0	1	0	0	1
9431	0	0	2	1	3
9432	0	2	2	0	4
9433	0	2	2	0	4
9434	0	2	6	0	8
9435	0	2	3	3	8
9436	0	3	5	1	9
9437	0	5	2	1	8
9439	0	3	1	1	5
9440	0	2	2	1	5
9441	0	1	6	0	7
9442	0	2	2	0	4
9443	0	1	3	1	5
9444	0	3	1	0	4
9445	0	3	5	0	8
9446	0	1	1	0	2
9447	0	4	4	1	9
9448	0	3	3	1	7
9449	0	1	4	0	5
9450	0	3	2	2	7
9451	0	6	3	1	10
9452	0	4	3	2	9
9453	0	1	5	1	7
9454	0	4	2	3	9
9455	0	1	2	0	3
9456	0	0	1	1	2
9457	0	1	2	0	3
9458	0	0	2	0	2
9459	0	2	2	0	4
9460	0	3	2	0	5
9461	0	2	6	2	10
9462	0	3	0	2	5
9463	0	3	3	1	7
9464	0	1	3	1	5
9465	0	2	2	0	4
9466	0	1	2	4	7
9467	0	3	4	2	9
9468	0	5	4	1	10
9469	0	2	0	2	4
9470	0	1	4	1	6
9471	0	4	2	0	6
9472	0	2	1	0	3
9473	0	0	5	0	5
9474	0	2	1	2	5
9475	0	3	6	2	11
9476	0	3	1	0	4
9477	0	3	3	0	6
9478	0	6	3	0	9
9479	0	0	2	0	2
9480	0	2	3	1	6
9481	0	1	1	1	3
9482	0	8	4	0	12
9483	0	2	2	1	5
9484	0	1	1	0	2
9485	0	4	6	1	11
9486	0	0	8	1	9
9487	0	3	2	0	5
9488	0	4	2	3	9
9489	0	5	1	0	6
9490	0	6	2	0	8
9491	0	4	1	0	5
9492	0	2	4	1	7
9493	0	1	6	2	9
9494	0	4	5	1	10
9495	0	2	0	1	3
9496	0	0	1	0	1
9497	0	3	1	3	7
9498	0	1	2	1	4
9499	0	1	4	4	9
9500	0	1	5	0	6
9501	0	3	3	3	9
9502	0	5	0	1	6
9503	0	3	4	0	7
9504	0	4	2	0	6
9505	0	3	0	0	3
9506	0	0	5	0	5
9507	0	2	3	0	5
9508	0	0	5	1	6
9509	0	1	2	0	3
9510	0	1	0	0	1
9511	0	3	1	0	4
9512	0	2	5	2	9
9513	0	4	0	1	5
9514	0	0	2	0	2
9515	0	1	3	2	6
9516	0	3	3	1	7
9517	0	1	4	0	5
9518	0	2	3	1	6
9519	0	2	1	1	4
9520	0	3	2	1	6
9521	0	3	0	1	4
9522	0	3	1	1	5
9523	0	2	3	0	5
9524	0	2	2	0	4
9525	0	3	2	0	5
9526	0	3	3	0	6
9527	0	2	3	1	6
9528	0	2	4	1	7
9529	0	2	1	2	5
9530	0	3	2	1	6
9531	0	3	4	2	9
9532	0	4	0	0	4
9533	0	1	2	0	3
9534	0	2	3	0	5
9535	0	1	2	0	3
9536	0	1	3	1	5
9537	0	4	2	0	6
9538	0	1	1	0	2
9539	0	1	2	1	4
9540	0	2	0	3	5
9541	0	4	3	1	8
9542	0	0	3	2	5
9543	0	2	1	2	5
9544	0	2	1	1	4
9545	0	4	1	0	5
9546	0	3	5	0	8
9547	0	0	3	0	3
9548	0	0	3	0	3
9549	0	3	4	0	7
9550	0	1	1	1	3
9551	0	1	0	0	1
9552	0	1	1	0	2
9553	0	1	4	1	6
9554	0	1	2	0	3
9555	0	1	4	1	6
9556	0	2	5	0	7
9557	0	1	3	3	7
9558	0	1	2	1	4
9559	0	2	5	1	8
9560	0	2	2	1	5
9561	0	0	2	0	2
9562	0	3	3	1	7
9563	0	2	2	4	8
9564	0	3	0	1	4
9565	0	2	2	1	5
9566	0	7	3	0	10
9567	0	1	2	1	4
9568	0	3	4	0	7
9569	0	1	2	0	3
9570	0	1	3	0	4
9571	0	0	1	2	3
9572	0	1	2	0	3
9573	0	1	1	0	2
9574	0	3	3	0	6
9575	0	4	4	0	8
9576	0	0	5	2	7
9577	0	0	4	0	4
9578	0	2	2	1	5
9579	0	2	2	1	5
9580	0	2	0	1	3
9581	0	0	3	1	4
9582	0	2	3	0	5
9583	0	6	6	0	12
9584	0	1	2	0	3
9585	0	2	1	0	3
9586	0	3	2	0	5
9587	0	3	3	1	7
9588	0	2	3	0	5
9589	0	3	4	2	9
9590	0	2	2	1	5
9591	0	3	3	0	6
9592	0	1	3	0	4
9593	0	1	3	0	4
9594	0	1	2	1	4
9595	0	2	1	1	4
9596	0	2	3	0	5
9597	0	2	3	0	5
9598	0	4	4	0	8
9599	0	3	5	0	8
9600	0	0	2	2	4
9601	0	2	1	0	3
9602	0	1	1	0	2
9603	0	2	5	0	7
9604	0	1	2	0	3
9605	0	4	1	1	6
9606	0	1	2	3	6
9607	0	2	2	0	4
9608	0	3	2	0	5
9609	0	1	3	0	4
9610	0	2	1	1	4
9611	0	3	3	0	6
9612	0	1	1	0	2
9613	0	1	2	1	4
9614	0	1	2	2	5
9615	0	3	1	0	4
9616	0	0	3	0	3
9617	0	3	7	0	10
9618	0	0	2	1	3
9619	0	4	2	0	6
9620	0	3	1	0	4
9621	0	5	0	0	5
9622	0	2	3	1	6
9623	0	1	3	1	5
9624	0	2	5	1	8
9625	0	3	4	1	8
9626	0	4	7	2	13
9627	0	2	1	0	3
9628	0	1	3	0	4
9629	0	2	1	0	3
9630	0	2	2	2	6
9631	0	3	2	0	5
9632	0	2	5	0	7
9633	0	4	4	0	8
9634	0	3	1	1	5
9635	0	0	3	0	3
9636	0	2	2	0	4
9637	0	4	1	2	7
9638	0	3	3	0	6
9639	0	1	5	0	6
9640	0	0	3	0	3
9641	0	2	6	1	9
9642	0	1	4	0	5
9643	0	2	3	0	5
9644	0	1	2	1	4
9645	0	1	5	0	6
9646	0	2	1	0	3
9647	0	2	5	1	8
9648	0	1	5	1	7
9649	0	3	0	1	4
9650	0	1	2	1	4
9651	0	1	3	1	5
9652	0	2	1	0	3
9653	0	1	3	0	4
9654	0	2	3	0	5
9655	0	4	1	0	5
9656	0	2	2	0	4
9657	0	1	1	0	2
9658	0	1	2	1	4
9659	0	1	4	1	6
9660	0	3	1	1	5
9661	0	2	1	0	3
9662	0	2	1	0	3
9663	0	2	1	1	4
9664	0	3	2	0	5
9665	0	0	2	2	4
9666	0	3	6	2	11
9667	0	0	3	1	4
9668	0	1	4	0	5
9669	0	3	3	0	6
9670	0	2	0	1	3
9671	0	0	1	0	1
9672	0	0	1	1	2
9673	0	1	5	1	7
9674	0	1	4	1	6
9675	0	0	0	1	1
9676	0	2	2	0	4
9677	0	1	5	3	9
9678	0	1	2	0	3
9679	0	2	6	0	8
9681	0	1	3	0	4
9682	0	0	3	1	4
9683	0	1	2	0	3
9684	0	2	2	1	5
9685	0	1	2	2	5
9686	0	2	1	1	4
9687	0	2	3	0	5
9688	0	3	1	0	4
9689	0	3	0	2	5
9690	0	3	3	2	8
9691	0	2	0	0	2
9692	0	0	1	1	2
9693	0	1	2	0	3
9694	0	2	1	0	3
9695	0	1	2	0	3
9696	0	4	0	0	4
9697	0	1	4	0	5
9698	0	2	2	0	4
9699	0	2	5	0	7
9700	0	2	2	1	5
9701	0	1	2	3	6
9702	0	1	1	0	2
9703	0	3	4	2	9
9704	0	3	2	0	5
9705	0	2	1	0	3
9706	0	1	3	0	4
9707	0	2	2	0	4
9708	0	3	3	0	6
9709	0	2	4	0	6
9710	0	1	4	1	6
9711	0	2	6	0	8
9712	0	5	2	1	8
9713	0	1	3	1	5
9714	0	1	1	0	2
9715	0	1	3	0	4
9716	0	3	3	0	6
9717	0	2	4	1	7
9718	0	2	4	1	7
9719	0	1	4	0	5
9720	0	0	1	1	2
9721	0	1	4	0	5
9722	0	3	1	1	5
9723	0	1	5	1	7
9724	0	3	1	1	5
9725	0	1	1	0	2
9726	0	5	0	0	5
9727	0	4	3	0	7
9728	0	2	2	0	4
9729	0	4	1	0	5
9730	0	2	3	0	5
9731	0	1	2	0	3
9732	0	1	3	2	6
9733	0	3	2	1	6
9734	0	4	3	2	9
9735	0	0	0	1	1
9736	0	0	1	1	2
9737	0	2	4	1	7
9738	0	1	2	0	3
9739	0	3	3	2	8
9740	0	2	4	0	6
9741	0	0	2	1	3
9742	0	1	2	1	4
9743	0	3	4	2	9
9744	0	0	1	1	2
9745	0	3	1	0	4
9746	0	2	2	1	5
9747	0	1	0	0	1
9748	0	4	5	0	9
9749	0	3	0	0	3
9751	0	2	2	0	4
9752	0	3	3	0	6
9753	0	2	2	1	5
9754	0	0	0	1	1
9755	0	2	3	0	5
9756	0	3	2	0	5
9757	0	2	5	0	7
9758	0	1	1	1	3
9759	0	2	4	1	7
9760	0	2	3	0	5
9761	0	1	0	0	1
9762	0	4	0	0	4
9763	0	2	1	0	3
9764	0	2	6	1	9
9765	0	4	0	2	6
9766	0	1	4	0	5
9767	0	0	6	1	7
9768	0	1	5	0	6
9769	0	1	0	1	2
9770	0	0	3	1	4
9771	0	0	5	0	5
9772	0	4	0	0	4
9773	0	1	5	3	9
9774	0	3	1	1	5
9775	0	1	5	2	8
9776	0	0	3	1	4
9777	0	1	1	0	2
9778	0	1	3	0	4
9779	0	1	5	0	6
9780	0	2	4	1	7
9781	0	2	5	0	7
9782	0	2	1	1	4
9783	0	1	4	0	5
9784	0	1	1	0	2
9785	0	2	1	1	4
9786	0	0	2	1	3
9787	0	2	3	1	6
9788	0	1	0	2	3
9789	0	4	2	0	6
9790	0	0	4	1	5
9791	0	0	2	1	3
9792	0	2	2	0	4
9793	0	1	5	1	7
9794	0	4	3	1	8
9795	0	4	1	1	6
9796	0	3	3	0	6
9797	0	0	2	0	2
9798	0	3	2	0	5
9799	0	1	2	0	3
9800	0	1	6	1	8
9801	0	2	1	2	5
9802	0	2	0	1	3
9803	0	3	5	0	8
9804	0	2	2	1	5
9805	0	1	0	0	1
9806	0	0	2	1	3
9807	0	3	3	0	6
9808	0	2	0	0	2
9809	0	4	3	0	7
9810	0	3	1	2	6
9811	0	2	1	2	5
9812	0	4	4	0	8
9813	0	2	0	1	3
9814	0	3	0	2	5
9815	0	2	1	1	4
9816	0	2	4	0	6
9817	0	0	3	1	4
9818	0	0	6	0	6
9819	0	4	0	2	6
9820	0	2	1	0	3
9821	0	9	5	1	15
9822	0	1	3	0	4
9823	0	1	2	1	4
9824	0	2	2	1	5
9825	0	2	1	0	3
9826	0	2	0	1	3
9827	0	1	2	2	5
9828	0	0	3	0	3
9829	0	2	3	2	7
9830	0	3	5	1	9
9831	0	1	3	1	5
9832	0	4	4	0	8
9833	0	2	1	0	3
9834	0	4	2	1	7
9835	0	1	1	1	3
9836	0	2	1	1	4
9837	0	1	2	0	3
9838	0	0	5	0	5
9839	0	2	0	1	3
9840	0	3	2	2	7
9841	0	0	2	0	2
9842	0	2	1	0	3
9843	0	4	2	1	7
9844	0	2	4	0	6
9845	0	2	1	0	3
9846	0	1	0	0	1
9847	0	2	2	0	4
9848	0	3	2	0	5
9849	0	3	2	0	5
9850	0	1	2	0	3
9851	0	0	2	0	2
9852	0	1	2	0	3
9853	0	2	4	1	7
9854	0	1	4	0	5
9855	0	4	6	0	10
9856	0	0	2	1	3
9857	0	2	2	1	5
9858	0	1	4	0	5
9859	0	1	3	2	6
9860	0	1	1	0	2
9861	0	1	2	1	4
9862	0	2	2	1	5
9863	0	2	1	1	4
9864	0	2	4	1	7
9865	0	1	2	2	5
9866	0	0	4	1	5
9867	0	2	1	1	4
9868	0	1	0	1	2
9869	0	4	1	0	5
9870	0	1	1	1	3
9871	0	3	1	1	5
9872	0	1	1	1	3
9873	0	3	1	0	4
9874	0	3	2	1	6
9875	0	0	0	1	1
9876	0	2	1	0	3
9877	0	4	4	1	9
9878	0	2	2	1	5
9879	0	0	1	0	1
9880	0	1	3	0	4
9881	0	0	3	0	3
9882	0	1	1	2	4
9883	0	3	3	1	7
9884	0	1	1	1	3
9885	0	0	4	0	4
9886	0	0	1	0	1
9887	0	4	2	1	7
9888	0	1	2	1	4
9889	0	4	2	1	7
9890	0	2	2	1	5
9891	0	1	3	1	5
9892	0	2	1	2	5
9893	0	0	2	2	4
9894	0	3	3	1	7
9895	0	0	5	0	5
9896	0	2	3	1	6
9897	0	0	2	1	3
9898	0	1	3	0	4
9899	0	1	1	0	2
9900	0	0	3	1	4
9901	0	4	2	2	8
9902	0	5	3	0	8
9903	0	4	4	1	9
9904	0	1	3	0	4
9905	0	1	5	3	9
9906	0	1	4	0	5
9907	0	0	1	3	4
9908	0	2	3	0	5
9909	0	2	4	0	6
9910	0	1	3	1	5
9911	0	1	1	1	3
9912	0	0	4	0	4
9913	0	1	2	1	4
9914	0	3	5	1	9
9915	0	3	2	2	7
9916	0	3	1	0	4
9917	0	1	1	0	2
9918	0	1	1	1	3
9919	0	3	2	0	5
9920	0	1	5	1	7
9921	0	1	2	1	4
9922	0	3	1	0	4
9923	0	0	5	0	5
9924	0	1	2	2	5
9925	0	2	3	0	5
9926	0	3	5	0	8
9927	0	0	4	1	5
9928	0	1	2	1	4
9929	0	0	2	1	3
9930	0	2	1	1	4
9931	0	1	3	1	5
9932	0	1	4	0	5
9933	0	2	3	1	6
9934	0	0	5	1	6
9935	0	1	1	0	2
9936	0	1	2	1	4
9938	0	0	7	2	9
9939	0	0	5	0	5
9940	0	3	5	0	8
9942	0	0	1	1	2
9943	0	4	1	0	5
9944	0	1	4	2	7
9945	0	2	0	4	6
9946	0	0	0	2	2
9947	0	3	3	0	6
9948	0	0	2	1	3
9949	0	2	0	1	3
9950	0	4	3	2	9
9951	0	1	1	0	2
9952	0	3	0	0	3
9953	0	0	1	1	2
9954	0	2	1	0	3
9955	0	1	2	0	3
9956	0	3	3	0	6
9957	0	2	3	0	5
9958	0	3	3	3	9
9959	0	1	5	1	7
9960	0	2	3	0	5
9961	0	2	2	2	6
9962	0	3	0	2	5
9963	0	1	1	0	2
9964	0	2	3	0	5
9965	0	3	2	1	6
9966	0	1	5	1	7
9967	0	1	2	1	4
9968	0	3	1	0	4
9969	0	0	3	0	3
9970	0	5	3	1	9
9971	0	2	3	1	6
9972	0	0	2	0	2
9973	0	0	1	0	1
9974	0	0	2	0	2
9975	0	3	1	1	5
9976	0	1	0	0	1
9977	0	1	4	2	7
9978	0	0	6	0	6
9979	0	2	3	1	6
9980	0	5	1	0	6
9981	0	2	0	2	4
9982	0	1	3	1	5
9983	0	4	3	0	7
9984	0	3	2	1	6
9985	0	2	5	1	8
9986	0	1	0	0	1
9987	0	4	3	1	8
9988	0	1	3	0	4
9989	0	1	2	0	3
9990	0	1	2	1	4
9991	0	1	0	0	1
9992	0	3	3	1	7
9993	0	4	3	1	8
9994	0	1	1	0	2
9995	0	3	2	0	5
9996	0	1	4	1	6
9997	0	1	4	1	6
9998	0	0	2	0	2
9999	0	2	0	0	2
10000	0	2	2	3	7
10001	0	0	3	1	4
10002	0	1	2	1	4
10003	0	2	1	0	3
10004	0	2	4	1	7
10005	0	0	4	0	4
10006	0	1	1	2	4
10007	0	2	4	0	6
10008	0	2	7	1	10
10009	0	2	2	0	4
10010	0	3	2	0	5
10011	0	3	3	0	6
10012	0	2	2	0	4
10013	0	1	3	1	5
10014	0	1	3	1	5
10015	0	3	1	0	4
10016	0	2	3	1	6
10017	0	2	1	1	4
10018	0	2	1	0	3
10019	0	1	4	0	5
10020	0	1	3	1	5
10021	0	2	2	0	4
10022	0	3	1	0	4
10023	0	0	1	1	2
10024	0	0	3	0	3
10025	0	3	2	0	5
10026	0	1	0	1	2
10027	0	2	1	0	3
10028	0	1	1	0	2
10029	0	1	4	2	7
10030	0	0	1	1	2
10031	0	3	1	0	4
10032	0	3	2	1	6
10033	0	2	2	2	6
10034	0	2	0	0	2
10035	0	2	2	2	6
10036	0	1	2	0	3
10038	0	1	4	1	6
10039	0	1	5	1	7
10040	0	1	5	4	10
10041	0	1	6	0	7
10042	0	2	3	0	5
10043	0	0	1	0	1
10044	0	2	4	0	6
10045	0	3	1	1	5
10046	0	1	1	0	2
10047	0	0	3	0	3
10048	0	1	0	2	3
10049	0	1	2	1	4
10050	0	1	2	0	3
10051	0	2	1	0	3
10052	0	1	3	0	4
10053	0	1	3	2	6
10054	0	0	4	0	4
10055	0	0	4	0	4
10057	0	0	1	0	1
10058	0	1	0	2	3
10059	0	0	4	2	6
10060	0	1	3	1	5
10061	0	2	3	0	5
10062	0	2	2	0	4
10063	0	1	2	1	4
10064	0	0	0	1	1
10065	0	3	1	0	4
10066	0	1	0	2	3
10067	0	1	3	0	4
10068	0	3	1	0	4
10069	0	0	2	3	5
10070	0	0	7	0	7
10071	0	5	0	0	5
10072	0	1	0	0	1
10073	0	0	2	1	3
10074	0	0	1	0	1
10075	0	0	1	2	3
10077	0	0	4	0	4
10078	0	2	3	1	6
10079	0	2	0	1	3
10080	0	0	2	1	3
10081	0	2	0	0	2
10082	0	0	4	0	4
10083	0	3	2	0	5
10084	0	1	2	2	5
10085	0	5	0	0	5
10086	0	2	1	0	3
10087	0	1	2	0	3
10088	0	1	1	0	2
10089	0	5	3	1	9
10090	0	0	2	1	3
10091	0	4	2	1	7
10092	0	0	2	2	4
10093	0	0	6	0	6
10094	0	0	1	0	1
10095	0	0	3	1	4
10096	0	1	1	0	2
10097	0	2	3	0	5
10098	0	0	2	0	2
10099	0	0	2	0	2
10100	0	2	3	0	5
10101	0	2	5	1	8
10102	0	2	4	1	7
10103	0	1	1	1	3
10104	0	1	2	0	3
10105	0	3	1	1	5
10106	0	2	1	1	4
10107	0	2	3	1	6
10108	0	1	5	0	6
10109	0	1	5	1	7
10110	0	4	1	0	5
10111	0	6	3	2	11
10112	0	0	4	1	5
10113	0	0	1	0	1
10114	0	1	1	1	3
10115	0	0	1	0	1
10116	0	2	2	1	5
10117	0	1	5	0	6
10118	0	0	2	0	2
10119	0	2	2	0	4
10120	0	2	2	1	5
10121	0	2	3	0	5
10122	0	0	3	0	3
10123	0	1	1	0	2
10124	0	2	2	0	4
10125	0	2	1	2	5
10126	0	0	3	0	3
10127	0	0	2	1	3
10128	0	5	0	0	5
10129	0	2	2	1	5
10130	0	2	4	2	8
10131	0	2	0	1	3
10132	0	2	4	0	6
10133	0	2	2	0	4
10134	0	0	2	1	3
10135	0	2	2	1	5
10136	0	3	2	1	6
10137	0	0	2	0	2
10138	0	2	4	0	6
10139	0	1	2	0	3
10140	0	2	1	0	3
10141	0	0	2	0	2
10142	0	1	2	1	4
10143	0	3	1	0	4
10144	0	2	2	2	6
10145	0	2	5	0	7
10146	0	1	2	1	4
10147	0	1	2	2	5
10148	0	3	1	0	4
10149	0	2	2	0	4
10150	0	2	0	3	5
10151	0	1	4	5	10
10152	0	2	3	0	5
10153	0	0	2	1	3
10154	0	0	2	1	3
10155	0	1	1	0	2
10156	0	1	1	1	3
10157	0	3	2	0	5
10158	0	2	1	1	4
10159	0	4	2	1	7
10160	0	0	1	0	1
10162	0	3	1	0	4
10163	0	1	1	1	3
10164	0	4	1	0	5
10165	0	2	4	1	7
10166	0	1	2	0	3
10167	0	0	1	1	2
10168	0	0	2	0	2
10169	0	3	0	1	4
10170	0	2	5	0	7
10171	0	1	1	1	3
10172	0	0	2	0	2
10173	0	0	2	2	4
10175	0	1	0	0	1
10176	0	4	3	3	10
10177	0	0	0	1	1
10178	0	1	1	0	2
10179	0	2	4	0	6
10180	0	3	1	1	5
10181	0	1	3	1	5
10182	0	1	2	0	3
10183	0	1	3	1	5
10184	0	1	0	0	1
10185	0	1	0	0	1
10186	0	0	4	2	6
10187	0	0	1	0	1
10188	0	1	1	1	3
10189	0	1	0	0	1
10190	0	3	5	1	9
10191	0	3	2	0	5
10192	0	1	1	0	2
10193	0	1	5	0	6
10194	0	3	2	1	6
10195	0	3	1	2	6
10196	0	1	2	3	6
10197	0	1	2	0	3
10198	0	2	2	2	6
10199	0	1	2	0	3
10200	0	1	3	1	5
10201	0	3	3	0	6
10202	0	2	1	0	3
10203	0	0	5	2	7
10204	0	3	3	0	6
10205	0	0	3	2	5
10206	0	1	2	0	3
10207	0	3	1	1	5
10208	0	1	0	0	1
10209	0	1	0	0	1
10210	0	1	3	0	4
10211	0	2	0	2	4
10212	0	0	3	0	3
10213	0	0	1	0	1
10214	0	1	2	0	3
10215	0	2	1	1	4
10216	0	2	0	1	3
10217	0	0	2	0	2
10218	0	0	3	1	4
10219	0	0	2	0	2
10220	0	2	3	0	5
10221	0	3	1	1	5
10222	0	0	4	2	6
10224	0	2	5	2	9
10225	0	2	2	1	5
10226	1	2	0	0	3
10227	0	1	3	0	4
10228	0	0	5	1	6
10229	0	1	1	0	2
10230	0	0	1	1	2
10231	0	3	3	0	6
10232	0	0	2	0	2
10233	0	4	0	0	4
10234	0	3	1	2	6
10235	0	2	2	0	4
10236	0	1	4	0	5
10237	0	5	3	2	10
10238	0	2	6	0	8
10239	0	1	1	0	2
10240	0	0	1	1	2
10241	0	2	1	0	3
10242	0	3	1	0	4
10243	0	1	3	2	6
10244	0	1	0	1	2
10245	0	1	0	0	1
10246	0	2	3	1	6
10247	0	0	1	1	2
10248	0	1	3	0	4
10249	0	2	1	0	3
10250	0	2	3	0	5
10251	0	0	1	0	1
10252	0	0	1	1	2
10253	0	4	1	1	6
10254	0	1	2	0	3
10255	0	2	4	0	6
10256	0	0	3	0	3
10257	0	4	1	1	6
10258	0	1	2	0	3
10259	0	2	0	1	3
10260	0	4	2	0	6
10261	0	0	0	2	2
10262	0	1	4	0	5
10263	0	0	1	2	3
10264	0	2	0	0	2
10265	0	2	2	2	6
10266	0	0	2	0	2
10267	0	1	2	0	3
10268	1	4	2	1	8
10269	0	1	5	0	6
10270	0	2	1	0	3
10271	0	1	0	1	2
10272	0	2	3	1	6
10273	0	0	1	1	2
10274	0	2	2	1	5
10275	0	1	0	0	1
10276	0	1	5	0	6
10277	0	3	3	0	6
10278	0	3	3	2	8
10279	0	1	3	0	4
10280	0	3	2	1	6
10281	0	2	3	2	7
10282	0	0	2	0	2
10283	0	3	2	0	5
10284	0	2	2	0	4
10285	0	1	3	1	5
10286	0	1	2	1	4
10287	0	4	0	2	6
10288	0	1	1	0	2
10289	0	0	1	2	3
10290	0	1	1	1	3
10291	0	1	1	0	2
10292	0	0	2	1	3
10293	0	3	2	0	5
10294	0	3	1	0	4
10295	0	0	4	2	6
10296	0	0	2	0	2
10297	0	4	2	2	8
10298	1	0	1	0	2
10299	0	2	2	0	4
10300	0	3	0	1	4
10301	0	0	3	0	3
10302	0	2	3	0	5
10303	0	4	4	1	9
10304	0	2	0	1	3
10305	1	0	4	0	5
10306	0	0	5	0	5
10307	0	2	3	0	5
10308	0	1	7	1	9
10309	0	1	2	0	3
10310	0	1	2	1	4
10311	0	4	3	1	8
10312	0	1	3	0	4
10313	0	0	1	1	2
10314	0	3	1	1	5
10315	0	3	3	2	8
10316	0	3	1	0	4
10317	0	1	2	1	4
10318	0	1	3	1	5
10319	0	2	2	0	4
10320	0	1	5	0	6
10321	0	1	2	1	4
10322	0	2	4	0	6
10323	0	1	5	1	7
10324	0	2	1	1	4
10325	0	3	2	0	5
10327	0	2	2	0	4
10328	0	3	2	0	5
10329	0	2	2	0	4
10330	1	1	1	0	3
10331	0	3	1	1	5
10332	0	2	2	0	4
10333	0	1	1	0	2
10334	0	4	1	0	5
10335	0	2	3	0	5
10336	0	3	3	0	6
10337	0	2	0	0	2
10338	0	2	5	0	7
10339	0	0	4	1	5
10340	0	3	1	0	4
10341	0	2	2	1	5
10342	0	1	5	0	6
10343	0	2	2	0	4
10344	0	1	4	1	6
10345	0	1	3	0	4
10346	0	2	2	1	5
10347	0	4	1	1	6
10348	0	1	4	0	5
10349	0	0	1	0	1
10350	0	0	1	0	1
10351	0	2	3	0	5
10352	0	3	3	0	6
10353	0	0	0	3	3
10354	0	2	3	0	5
10355	0	3	0	0	3
10356	0	0	3	0	3
10357	0	1	3	0	4
10358	0	3	5	0	8
10360	0	3	2	1	6
10361	0	3	1	0	4
10362	0	2	2	1	5
10363	0	0	1	1	2
10364	0	2	2	0	4
10366	0	3	1	0	4
10367	0	0	3	0	3
10368	0	0	2	0	2
10369	0	3	3	0	6
10370	0	5	3	0	8
10371	0	2	1	0	3
10372	0	1	1	0	2
10373	0	2	1	0	3
10374	0	0	4	0	4
10375	0	1	3	1	5
10376	0	0	3	1	4
10377	0	0	3	0	3
10378	0	2	2	1	5
10379	0	5	3	0	8
10380	0	1	2	0	3
10381	0	1	3	2	6
10382	0	3	3	3	9
10383	0	1	1	0	2
10384	0	2	1	0	3
10385	0	1	1	0	2
10386	1	4	1	0	6
10387	0	0	3	1	4
10388	0	0	2	0	2
10389	0	1	0	0	1
10390	0	0	3	0	3
10392	0	2	0	1	3
10393	0	2	3	1	6
10394	0	3	1	0	4
10395	0	1	2	2	5
10396	0	1	1	0	2
10397	0	2	3	1	6
10398	0	1	1	0	2
10399	0	0	2	0	2
10400	0	2	4	0	6
10401	0	1	0	0	1
10402	0	1	0	0	1
10403	0	1	2	0	3
10404	0	1	2	0	3
10405	0	1	2	1	4
10406	0	1	4	0	5
10407	0	1	0	0	1
10408	0	2	3	0	5
10409	0	1	3	0	4
10410	0	1	3	0	4
10411	0	2	1	0	3
10412	0	1	1	0	2
10413	0	2	3	0	5
10414	0	1	0	1	2
10415	0	1	2	0	3
10416	0	2	1	1	4
10417	0	1	5	1	7
10418	0	2	1	2	5
10419	0	1	1	0	2
10420	0	5	5	1	11
10421	0	1	1	1	3
10422	0	1	1	2	4
10423	0	0	3	2	5
10424	0	2	1	1	4
10425	0	2	2	2	6
10426	0	0	1	0	1
10427	0	0	0	1	1
10428	0	1	1	0	2
10429	0	1	0	1	2
10430	0	2	3	0	5
10431	0	1	1	0	2
10432	0	3	2	1	6
10433	0	1	1	1	3
10434	0	2	2	0	4
10435	0	2	0	1	3
10436	0	2	0	0	2
10437	0	1	3	0	4
10438	0	0	0	1	1
10439	1	3	2	0	6
10440	0	3	4	1	8
10441	0	2	1	0	3
10442	0	1	0	0	1
10443	0	1	3	0	4
10444	0	1	2	1	4
10445	0	3	2	2	7
10446	0	1	1	0	2
10447	0	2	1	1	4
10448	0	2	3	0	5
10449	0	1	2	1	4
10450	0	3	0	1	4
10451	0	0	3	0	3
10452	0	1	0	2	3
10453	0	2	2	0	4
10454	0	0	2	0	2
10455	0	2	2	0	4
10456	0	1	1	1	3
10457	0	0	2	0	2
10458	0	1	0	0	1
10459	0	0	1	0	1
10460	0	0	3	0	3
10461	0	2	3	0	5
10462	0	2	0	0	2
10463	0	1	1	0	2
10465	0	4	2	0	6
10466	0	4	1	0	5
10467	0	1	3	0	4
10469	0	4	4	0	8
10470	0	2	3	0	5
10471	0	2	0	2	4
10472	0	0	1	0	1
10473	0	0	2	0	2
10474	0	1	2	1	4
10475	0	2	0	0	2
10476	0	0	1	1	2
10477	0	2	3	0	5
10478	0	0	0	1	1
10479	0	2	2	0	4
10480	0	1	2	1	4
10481	0	1	2	1	4
10482	0	2	2	2	6
10483	1	2	4	0	7
10484	0	0	1	1	2
10485	0	1	1	0	2
10486	0	2	1	0	3
10487	0	0	1	2	3
10488	0	0	1	0	1
10489	0	2	3	1	6
10490	0	0	3	0	3
10491	0	2	1	0	3
10493	0	1	1	0	2
10494	0	1	3	0	4
10495	0	0	3	0	3
10496	0	2	3	2	7
10497	0	2	2	0	4
10498	0	2	3	1	6
10499	0	2	0	0	2
10500	0	0	1	0	1
10501	0	1	1	0	2
10502	0	2	2	0	4
10503	0	1	3	1	5
10504	0	1	5	1	7
10505	0	2	2	1	5
10506	0	1	0	1	2
10507	0	2	2	0	4
10508	0	1	1	0	2
10509	0	3	3	0	6
10510	0	0	3	0	3
10511	0	3	2	0	5
10512	0	1	1	0	2
10513	0	0	1	0	1
10514	0	0	2	0	2
10515	0	2	1	0	3
10516	0	2	2	1	5
10517	0	0	2	0	2
10519	0	3	1	1	5
10520	0	1	1	0	2
10521	0	1	1	0	2
10522	0	4	0	0	4
10523	0	1	1	0	2
10524	0	1	2	1	4
10525	0	1	4	0	5
10526	0	2	4	0	6
10527	0	2	0	0	2
10528	0	0	2	0	2
10529	0	1	2	1	4
10530	0	2	1	1	4
10531	0	4	0	0	4
10532	0	2	1	2	5
10533	0	2	0	3	5
10534	0	0	4	0	4
10535	0	1	1	0	2
10536	0	1	3	1	5
10537	0	2	2	0	4
10538	0	3	0	0	3
10539	0	1	1	0	2
10540	0	1	0	0	1
10541	0	3	1	0	4
10542	0	1	2	0	3
10543	0	1	2	1	4
10544	0	1	3	0	4
10545	0	1	3	0	4
10546	0	0	1	0	1
10547	0	1	3	2	6
10548	0	1	4	0	5
10549	0	3	0	0	3
10550	0	1	2	1	4
10551	0	0	3	0	3
10552	0	4	2	1	7
10553	0	1	1	0	2
10554	0	2	1	0	3
10555	0	0	2	0	2
10556	0	0	0	2	2
10557	0	1	0	0	1
10558	0	1	1	0	2
10560	0	0	2	1	3
10561	0	2	4	0	6
10562	0	5	1	0	6
10563	0	1	6	1	8
10564	0	4	1	1	6
10565	0	1	0	1	2
10566	0	2	0	0	2
10567	0	2	3	0	5
10568	0	0	1	1	2
10569	0	2	1	0	3
10570	0	1	1	0	2
10571	0	1	1	0	2
10572	0	1	1	0	2
10573	0	2	0	0	2
10574	0	1	2	0	3
10575	0	0	1	0	1
10576	0	0	2	0	2
10577	0	0	2	0	2
10578	0	3	3	1	7
10579	0	1	2	0	3
10580	0	1	2	0	3
10581	0	1	1	1	3
10582	0	2	1	1	4
10583	0	3	0	0	3
10584	0	1	1	1	3
10585	0	1	0	1	2
10586	0	4	2	1	7
10587	0	1	2	2	5
10588	0	1	0	1	2
10589	0	1	1	0	2
10590	0	0	2	0	2
10591	0	1	3	0	4
10592	0	0	1	1	2
10593	0	1	2	0	3
10594	0	4	1	1	6
10595	0	1	1	0	2
10596	0	0	2	1	3
10597	0	1	2	1	4
10598	0	0	2	3	5
10599	0	5	1	0	6
10600	0	1	6	0	7
10601	0	1	2	0	3
10602	1	2	1	0	4
10603	0	0	1	2	3
10604	0	3	0	0	3
10605	0	2	0	0	2
10606	0	4	2	0	6
10607	0	3	0	0	3
10608	0	3	1	0	4
10609	0	1	0	0	1
10610	0	2	1	1	4
10611	0	1	1	1	3
10612	0	2	1	0	3
10613	0	0	1	0	1
10615	0	0	2	0	2
10616	0	0	1	2	3
10617	0	1	0	0	1
10618	0	0	0	1	1
10619	0	2	1	0	3
10620	0	0	2	1	3
10621	0	0	3	0	3
10622	0	2	4	1	7
10623	0	1	2	0	3
10624	0	3	2	0	5
10625	0	1	1	0	2
10626	0	0	3	1	4
10627	0	1	2	1	4
10628	0	1	1	1	3
10629	0	0	2	0	2
10630	0	1	0	0	1
10631	0	1	3	2	6
10632	0	1	1	0	2
10633	0	3	0	1	4
10634	0	0	2	1	3
10635	0	1	2	0	3
10636	0	3	2	0	5
10637	0	0	1	1	2
10638	0	1	1	3	5
10639	0	0	2	0	2
10640	0	2	0	1	3
10641	1	2	1	0	4
10642	0	0	3	0	3
10643	0	1	2	0	3
10644	0	0	3	0	3
10645	0	1	3	0	4
10647	0	1	0	0	1
10648	0	2	1	2	5
10649	0	1	3	0	4
10650	0	1	1	0	2
10651	0	1	2	1	4
10652	0	1	1	1	3
10653	0	2	5	0	7
10654	0	0	1	0	1
10655	0	2	3	0	5
10656	0	1	2	0	3
10657	0	2	1	0	3
10658	0	2	0	0	2
10659	0	1	0	1	2
10660	0	1	1	1	3
10661	0	0	2	0	2
10662	0	2	0	1	3
10663	0	3	1	0	4
10664	0	2	3	0	5
10665	0	0	2	2	4
10666	0	1	2	0	3
10667	0	2	0	0	2
10668	0	1	4	0	5
10669	0	0	1	0	1
10670	0	2	1	1	4
10671	0	1	1	1	3
10672	0	2	2	0	4
10673	0	2	2	1	5
10674	0	1	1	0	2
10675	0	1	3	0	4
10676	0	0	0	3	3
10677	0	1	1	0	2
10678	0	3	0	0	3
10679	0	2	2	0	4
10680	0	1	0	0	1
10681	0	1	0	1	2
10682	0	2	1	0	3
10683	0	3	1	0	4
10684	0	1	1	1	3
10685	0	2	0	0	2
10686	0	2	3	0	5
10687	0	1	2	0	3
10688	0	3	3	0	6
10689	0	3	1	1	5
10690	0	2	5	1	8
10691	0	1	0	1	2
10692	0	0	1	0	1
10693	0	0	2	0	2
10694	0	1	2	0	3
10695	0	1	2	0	3
10696	0	1	2	2	5
10697	0	1	3	0	4
10698	0	1	2	0	3
10699	0	1	1	0	2
10700	0	1	1	2	4
10701	0	2	3	0	5
10702	0	0	2	0	2
10703	0	3	1	1	5
10704	0	0	1	0	1
10705	0	0	1	1	2
10706	0	1	0	1	2
10707	0	0	2	1	3
10708	0	1	2	0	3
10709	0	1	1	0	2
10710	0	0	5	0	5
10711	0	0	3	0	3
10712	0	0	3	1	4
10713	0	1	1	0	2
10714	0	3	4	2	9
10715	0	6	1	0	7
10716	0	2	1	0	3
10717	0	2	2	0	4
10718	0	1	1	0	2
10719	0	0	2	1	3
10720	0	0	1	1	2
10721	0	1	2	0	3
10722	0	1	2	2	5
10723	0	3	0	0	3
10724	0	1	0	0	1
10725	0	1	3	1	5
10726	0	0	2	0	2
10727	0	1	1	1	3
10728	0	1	0	0	1
10729	0	1	0	3	4
10730	0	2	2	1	5
10731	0	1	1	0	2
10732	0	0	1	0	1
10733	0	2	4	0	6
10734	0	1	1	2	4
10735	0	1	1	0	2
10736	0	0	1	1	2
10737	0	1	0	0	1
10738	0	1	1	0	2
10739	0	0	3	2	5
10740	0	0	1	0	1
10741	0	0	1	0	1
10742	0	4	0	3	7
10743	0	4	0	0	4
10745	0	1	2	0	3
10746	0	2	1	1	4
10747	1	0	0	0	1
10748	0	1	0	0	1
10749	0	3	1	0	4
10750	0	1	4	0	5
10752	0	2	1	4	7
10753	0	2	2	1	5
10754	0	1	1	2	4
10755	0	3	0	2	5
10756	0	0	4	0	4
10757	0	0	1	1	2
10758	0	3	1	0	4
10759	0	1	0	0	1
10760	0	2	0	1	3
10761	0	1	1	1	3
10762	0	0	0	1	1
10763	0	1	0	0	1
10764	0	0	1	2	3
10765	0	1	1	1	3
10766	0	2	1	0	3
10767	0	1	1	0	2
10768	0	2	2	1	5
10770	0	1	0	0	1
10771	0	1	0	1	2
10772	0	1	1	2	4
10773	0	0	1	0	1
10774	0	2	2	1	5
10775	0	2	1	0	3
10776	0	1	3	0	4
10777	0	1	2	0	3
10778	0	2	0	0	2
10779	0	2	1	1	4
10780	0	1	1	0	2
10781	0	1	1	1	3
10782	0	4	1	1	6
10783	0	3	5	0	8
10784	0	0	0	1	1
10785	0	1	2	0	3
10786	0	0	1	2	3
10787	0	0	4	0	4
10788	0	2	0	1	3
10789	0	0	2	1	3
10790	0	1	2	1	4
10791	0	2	4	0	6
10792	0	2	0	0	2
10794	0	0	1	0	1
10795	1	0	3	1	5
10796	0	3	2	0	5
10797	0	0	1	1	2
10798	0	5	1	0	6
10799	0	1	2	1	4
10800	0	2	1	0	3
10801	0	1	1	1	3
10802	0	1	3	1	5
10803	0	3	2	2	7
10804	0	4	0	0	4
10805	0	2	0	0	2
10806	0	1	2	1	4
10807	0	2	1	0	3
10808	0	1	2	0	3
10809	0	2	2	0	4
10810	0	2	1	0	3
10811	0	0	3	1	4
10812	0	2	2	1	5
10813	0	1	0	1	2
10814	0	2	0	0	2
10815	0	0	3	0	3
10816	0	1	1	0	2
10817	0	3	1	0	4
10818	0	1	1	0	2
10819	0	2	0	0	2
10820	0	1	3	1	5
10821	0	1	1	0	2
10822	0	1	3	1	5
10823	0	0	1	1	2
10824	0	0	1	1	2
10825	0	0	1	0	1
10826	0	1	1	1	3
10827	0	1	2	0	3
10828	0	0	1	0	1
10829	0	2	1	1	4
10830	0	0	1	0	1
10831	0	1	0	1	2
10832	0	2	3	0	5
10833	0	2	0	1	3
10834	0	3	3	0	6
10835	0	2	1	0	3
10836	0	2	3	0	5
10837	0	2	4	1	7
10838	0	2	3	0	5
10839	0	1	2	0	3
10840	0	2	1	0	3
10841	0	1	3	0	4
10842	0	1	1	1	3
10843	0	2	2	2	6
10844	0	1	2	0	3
10845	0	0	1	0	1
10846	0	2	1	0	3
10847	0	2	0	3	5
10848	0	1	3	0	4
10849	0	0	2	0	2
10850	0	1	1	0	2
10851	0	2	0	1	3
10852	0	0	1	1	2
10853	0	0	1	1	2
10854	0	1	0	1	2
10855	0	0	1	1	2
10856	0	1	2	0	3
10857	0	0	1	0	1
10858	0	2	2	0	4
10859	0	1	0	0	1
10860	0	0	0	1	1
10861	0	0	1	0	1
10862	0	1	4	1	6
10863	0	1	2	1	4
10864	0	0	4	0	4
10865	0	2	1	0	3
10867	0	1	0	0	1
10868	0	0	2	0	2
10869	0	0	1	1	2
10870	0	0	1	0	1
10871	0	2	2	1	5
10872	0	0	1	1	2
10873	0	3	0	1	4
10874	0	1	3	0	4
10875	0	2	2	0	4
10876	0	2	0	0	2
10877	0	1	2	0	3
10878	0	1	1	1	3
10879	0	1	2	0	3
10880	0	3	0	2	5
10881	0	0	2	0	2
10882	0	0	2	0	2
10883	0	1	3	1	5
10884	0	0	3	3	6
10885	0	0	4	1	5
10886	0	0	3	0	3
10887	0	1	0	1	2
10888	0	1	1	1	3
10889	0	2	0	0	2
10890	0	1	2	1	4
10891	0	2	0	1	3
10892	0	0	1	0	1
10893	0	3	1	0	4
10894	0	1	2	0	3
10895	0	2	1	1	4
10896	0	1	0	0	1
10897	0	1	2	0	3
10898	0	0	7	0	7
10899	0	2	2	0	4
10900	0	1	1	0	2
10901	0	2	2	0	4
10902	0	0	1	0	1
10903	0	1	1	0	2
10904	0	3	1	0	4
10905	0	2	3	0	5
10906	0	2	1	1	4
10907	0	1	1	1	3
10908	0	0	0	2	2
10909	0	2	0	0	2
10910	0	0	3	1	4
10911	0	2	1	0	3
10912	0	2	2	0	4
10913	0	4	2	2	8
10914	0	0	1	0	1
10915	0	1	4	0	5
10916	0	2	3	0	5
10917	0	2	1	0	3
10918	0	0	2	0	2
10919	0	0	2	2	4
10920	0	4	0	0	4
10921	0	4	1	1	6
10922	0	0	1	0	1
10923	0	1	1	3	5
10924	0	0	4	1	5
10925	0	0	0	2	2
10928	0	0	0	2	2
10929	0	1	2	1	4
10930	0	1	2	0	3
10931	0	3	3	0	6
10932	0	1	3	0	4
10933	0	0	2	1	3
10934	0	4	0	0	4
10935	0	4	1	0	5
10936	0	0	2	0	2
10938	1	2	0	0	3
10939	0	0	0	1	1
10940	0	0	2	0	2
10941	0	0	1	0	1
10942	0	0	4	1	5
10943	0	0	1	0	1
10944	0	2	0	0	2
10945	0	1	0	0	1
10946	0	0	1	1	2
10947	0	1	0	1	2
10948	0	0	1	0	1
10949	0	1	1	0	2
10950	0	2	1	1	4
10951	0	1	2	1	4
10952	0	3	2	0	5
10953	0	0	1	2	3
10954	0	0	1	0	1
10955	0	0	4	0	4
10956	0	1	3	0	4
10957	0	3	2	0	5
10958	0	1	1	1	3
10959	0	2	1	1	4
10960	0	2	1	0	3
10961	0	1	0	0	1
10962	0	0	2	0	2
10963	1	0	3	0	4
10964	0	1	1	0	2
10965	0	1	0	0	1
10966	0	0	2	0	2
10967	0	0	1	1	2
10968	0	2	3	1	6
10969	0	0	1	1	2
10970	0	0	1	0	1
10971	0	1	1	0	2
10972	0	0	0	2	2
10973	0	2	0	0	2
10974	0	1	3	1	5
10975	0	2	0	1	3
10976	0	0	0	1	1
10977	0	1	0	0	1
10978	0	1	2	2	5
10980	0	1	1	0	2
10981	0	1	2	0	3
10982	0	0	1	0	1
10983	0	2	0	0	2
10984	0	3	2	1	6
10986	0	2	1	1	4
10987	0	2	2	0	4
10988	0	3	0	0	3
10989	0	1	0	0	1
10990	0	1	1	0	2
10991	0	1	2	0	3
10992	0	1	0	3	4
10993	0	1	3	0	4
10994	0	3	1	0	4
10995	0	1	0	0	1
10996	0	1	0	0	1
10997	0	0	1	0	1
10998	0	4	2	1	7
10999	0	2	0	0	2
11000	1	1	0	2	4
11001	0	0	2	0	2
11002	0	5	0	0	5
11003	0	1	3	1	5
11004	0	2	6	0	8
11005	0	2	1	1	4
11006	0	2	1	0	3
11007	0	2	0	1	3
11008	0	1	1	0	2
11009	0	0	3	1	4
11010	0	3	1	0	4
11011	0	1	0	0	1
11012	0	3	1	0	4
11013	0	0	3	0	3
11014	0	0	2	1	3
11015	0	2	0	0	2
11016	0	1	2	0	3
11017	0	1	3	0	4
11018	0	1	1	0	2
11021	0	0	3	0	3
11022	0	0	1	0	1
11024	0	2	4	1	7
11025	0	2	2	0	4
11026	0	0	1	2	3
11028	0	3	0	1	4
11029	0	0	2	0	2
11030	0	1	3	0	4
11031	0	0	0	1	1
11032	0	2	1	0	3
11033	0	0	2	1	3
11034	0	1	0	1	2
11035	0	1	2	0	3
11036	0	2	1	0	3
11037	0	0	1	1	2
11038	0	0	1	0	1
11039	0	2	1	0	3
11040	0	1	3	1	5
11041	0	2	1	0	3
11042	0	1	2	0	3
11043	0	0	2	1	3
11044	0	1	0	1	2
11045	0	0	1	0	1
11046	0	1	3	0	4
11047	0	0	1	1	2
11048	0	2	0	0	2
11049	0	1	1	0	2
11050	0	1	0	0	1
11051	0	1	3	0	4
11052	0	0	2	0	2
11053	0	1	1	3	5
11054	0	2	0	2	4
11055	0	0	3	0	3
11056	0	1	3	0	4
11057	0	3	1	0	4
11058	0	2	1	1	4
11060	0	0	2	1	3
11061	0	1	0	0	1
11062	0	1	2	0	3
11063	0	1	1	1	3
11064	0	1	1	0	2
11065	0	1	2	0	3
11066	0	1	0	2	3
11067	0	0	2	2	4
11068	0	1	1	1	3
11069	0	1	2	0	3
11071	0	2	2	1	5
11072	0	0	2	1	3
11073	0	0	3	1	4
11074	0	3	1	1	5
11075	0	0	1	1	2
11076	0	0	1	0	1
11077	0	0	2	0	2
11078	0	0	1	0	1
11079	0	1	2	0	3
11080	0	0	1	0	1
11081	0	0	0	1	1
11082	0	1	0	1	2
11084	0	1	0	3	4
11085	0	3	0	2	5
11086	0	3	0	1	4
11087	0	1	0	0	1
11089	0	2	2	1	5
11090	0	0	0	2	2
11091	0	1	2	0	3
11092	0	1	3	0	4
11093	0	2	2	2	6
11094	0	2	0	1	3
11095	0	0	0	1	1
11096	0	2	0	0	2
11097	0	1	1	0	2
11098	0	2	1	0	3
11099	0	0	0	1	1
11100	0	0	1	1	2
11101	0	2	1	0	3
11102	0	2	1	0	3
11103	0	1	2	0	3
11104	0	2	3	0	5
11105	0	2	1	1	4
11106	0	1	4	0	5
11107	0	0	1	1	2
11108	0	2	1	0	3
11109	0	1	3	1	5
11110	0	0	3	0	3
11111	0	2	2	0	4
11112	0	2	1	0	3
11113	0	0	3	0	3
11114	0	1	0	0	1
11115	0	0	2	0	2
11116	0	1	3	0	4
11117	0	1	4	0	5
11118	0	1	2	1	4
11120	0	2	2	0	4
11122	0	4	2	0	6
11123	0	2	1	0	3
11124	0	1	3	0	4
11125	0	0	0	1	1
11126	0	1	1	0	2
11127	0	1	1	0	2
11129	0	0	2	1	3
11130	0	1	0	0	1
11131	0	1	1	1	3
11133	0	1	0	0	1
11134	0	0	3	0	3
11135	0	1	0	1	2
11137	2	0	1	0	3
11138	0	0	2	0	2
11139	0	0	0	1	1
11140	0	1	1	1	3
11141	0	1	2	0	3
11142	0	0	1	0	1
11143	0	1	2	0	3
11144	0	3	2	1	6
11146	0	1	2	2	5
11147	0	2	3	0	5
11148	0	1	1	0	2
11149	0	0	0	1	1
11150	0	0	2	0	2
11151	0	0	2	0	2
11152	0	1	2	0	3
11153	0	1	0	0	1
11154	0	3	0	1	4
11155	0	0	2	2	4
11157	0	2	0	0	2
11158	0	2	3	0	5
11159	0	1	2	1	4
11161	0	0	1	0	1
11162	0	0	1	0	1
11163	0	1	1	1	3
11164	0	4	2	0	6
11165	0	1	3	0	4
11166	0	0	1	0	1
11168	0	0	1	0	1
11170	0	3	2	1	6
11171	0	1	1	2	4
11172	0	2	0	0	2
11173	0	0	1	0	1
11174	0	2	2	0	4
11175	0	1	4	0	5
11176	0	2	0	0	2
11177	0	0	4	0	4
11178	0	2	0	2	4
11179	0	1	1	0	2
11180	0	1	1	0	2
11181	0	0	0	1	1
11183	0	2	1	0	3
11184	0	2	1	0	3
11185	0	1	2	0	3
11186	0	1	1	0	2
11187	0	2	4	1	7
11189	0	1	1	0	2
11191	0	0	0	1	1
11192	0	0	0	1	1
11193	0	2	2	2	6
11194	0	1	2	0	3
11195	0	1	3	0	4
11196	0	2	3	0	5
11197	0	2	1	0	3
11199	0	1	1	1	3
11200	0	0	1	0	1
11201	0	1	2	0	3
11203	0	2	0	1	3
11204	0	1	2	1	4
11205	0	2	0	0	2
11206	0	0	0	1	1
11209	0	2	1	1	4
11211	0	0	1	0	1
11212	0	1	2	0	3
11214	0	2	0	0	2
11215	0	0	5	1	6
11216	0	0	1	0	1
11217	0	0	1	1	2
11218	0	0	4	2	6
11219	0	1	2	0	3
11220	0	1	1	0	2
11221	0	3	1	0	4
11222	0	0	3	0	3
11223	0	1	2	0	3
11225	0	1	1	0	2
11226	0	2	1	1	4
11227	0	0	1	1	2
11228	0	2	2	0	4
11230	0	0	1	0	1
11231	0	1	1	1	3
11232	0	1	0	0	1
11233	0	1	0	2	3
11234	0	0	2	0	2
11235	0	1	1	0	2
11236	0	0	2	0	2
11237	0	0	0	1	1
11240	0	1	1	0	2
11241	0	0	1	0	1
11242	0	1	2	0	3
11243	0	3	1	0	4
11244	0	1	1	0	2
11245	0	0	2	0	2
11246	0	0	1	1	2
11247	0	1	1	1	3
11248	0	1	2	0	3
11249	0	1	1	0	2
11250	0	2	0	2	4
11251	0	1	1	0	2
11252	0	1	1	0	2
11253	0	1	4	1	6
11254	0	2	1	0	3
11255	0	3	2	0	5
11257	0	0	2	1	3
11258	0	0	2	0	2
11261	0	0	1	0	1
11262	0	3	3	1	7
11263	0	1	3	1	5
11264	0	1	1	2	4
11265	0	1	0	2	3
11266	0	0	2	0	2
11267	0	0	0	1	1
11268	0	1	1	0	2
11269	0	1	2	1	4
11270	0	0	3	0	3
11271	0	0	1	0	1
11272	0	0	1	2	3
11273	0	2	0	0	2
11274	0	3	0	0	3
11275	0	3	0	0	3
11276	0	0	1	1	2
11277	0	1	2	0	3
11278	0	3	1	0	4
11279	0	0	2	0	2
11280	0	1	2	1	4
11281	0	2	2	0	4
11282	0	1	1	1	3
11283	0	1	5	0	6
11284	0	0	1	0	1
11285	0	1	0	0	1
11286	0	0	0	1	1
11287	0	1	0	1	2
11288	0	0	1	0	1
11290	0	0	0	1	1
11291	0	1	2	1	4
11292	0	1	0	0	1
11294	0	0	3	1	4
11296	0	1	2	1	4
11298	0	2	1	0	3
11299	0	0	2	0	2
11300	0	0	0	1	1
11301	0	1	0	0	1
11302	0	2	1	0	3
11303	0	0	3	0	3
11304	0	1	1	1	3
11305	0	1	3	0	4
11306	0	0	2	1	3
11307	0	4	2	0	6
11308	0	0	0	1	1
11309	0	1	1	0	2
11310	0	1	0	0	1
11311	0	0	1	0	1
11312	0	2	1	1	4
11313	0	0	2	0	2
11314	0	2	0	0	2
11315	0	2	3	0	5
11316	0	2	1	0	3
11317	0	0	0	1	1
11318	0	1	1	0	2
11319	0	0	2	0	2
11321	0	0	2	0	2
11322	0	0	1	0	1
11323	0	1	1	1	3
11324	0	0	2	1	3
11325	0	1	2	0	3
11326	0	0	1	1	2
11327	0	2	0	0	2
11328	0	1	0	0	1
11329	0	1	0	0	1
11330	0	0	1	0	1
11331	0	0	2	1	3
11332	0	1	0	0	1
11333	0	1	2	0	3
11334	0	1	2	0	3
11335	0	0	0	1	1
11336	0	1	1	1	3
11337	0	0	2	0	2
11338	0	1	0	1	2
11339	0	0	2	1	3
11340	0	2	1	1	4
11341	0	1	2	0	3
11342	0	3	0	2	5
11343	0	1	0	0	1
11344	0	1	0	0	1
11345	0	2	3	0	5
11346	0	2	2	1	5
11347	0	0	1	0	1
11348	0	2	1	0	3
11349	0	1	1	0	2
11351	0	2	0	0	2
11352	0	1	2	0	3
11353	0	0	1	1	2
11354	0	0	1	1	2
11355	0	1	4	0	5
11356	0	2	4	0	6
11357	0	1	0	0	1
11358	0	1	1	1	3
11359	0	1	1	1	3
11360	0	1	0	0	1
11362	0	1	2	0	3
11364	0	3	1	0	4
11366	0	0	1	0	1
11367	0	1	1	0	2
11368	0	1	3	1	5
11369	0	1	2	0	3
11370	0	0	2	1	3
11371	0	0	1	0	1
11372	0	1	3	1	5
11373	0	1	0	0	1
11374	0	1	1	1	3
11375	0	0	1	1	2
11376	0	0	1	1	2
11377	0	2	1	2	5
11378	0	1	0	0	1
11379	0	1	2	1	4
11380	0	1	1	0	2
11381	0	1	1	1	3
11382	0	0	3	0	3
11383	0	1	3	0	4
11384	0	1	1	0	2
11385	0	2	0	0	2
11386	0	0	0	1	1
11387	0	1	1	0	2
11388	0	0	2	1	3
11389	0	0	0	2	2
11390	0	0	1	0	1
11391	0	1	1	0	2
11392	0	1	0	0	1
11393	0	0	2	0	2
11394	0	0	1	0	1
11395	0	2	0	2	4
11398	0	0	0	1	1
11399	0	0	2	0	2
11400	0	3	1	1	5
11402	0	1	2	1	4
11403	0	2	1	0	3
11404	0	0	1	1	2
11405	0	1	0	1	2
11406	0	0	0	1	1
11407	0	1	0	0	1
11408	0	2	2	0	4
11411	0	1	1	0	2
11412	0	0	0	1	1
11413	0	1	1	0	2
11414	0	0	1	0	1
11415	0	2	0	1	3
11416	0	1	3	0	4
11417	0	1	0	0	1
11418	0	0	1	0	1
11419	0	1	1	0	2
11420	0	0	0	1	1
11421	0	0	0	1	1
11422	0	2	1	0	3
11423	0	0	0	1	1
11424	0	2	1	1	4
11425	0	1	4	1	6
11426	0	2	2	0	4
11427	0	0	1	0	1
11428	0	0	1	1	2
11430	0	2	0	1	3
11431	0	3	3	0	6
11433	0	3	1	0	4
11434	0	1	0	0	1
11435	0	2	0	0	2
11436	0	1	0	2	3
11437	0	0	1	0	1
11438	0	4	0	1	5
11439	0	1	1	0	2
11440	0	2	0	0	2
11441	0	0	1	0	1
11442	0	1	1	0	2
11444	0	3	2	0	5
11445	0	1	0	0	1
11446	0	0	2	0	2
11448	0	4	0	0	4
11449	0	0	1	0	1
11450	0	3	2	0	5
11451	0	1	1	2	4
11452	0	0	3	0	3
11453	0	1	1	0	2
11454	0	2	1	0	3
11455	0	1	1	1	3
11456	0	3	0	1	4
11458	0	1	2	0	3
11459	0	0	3	0	3
11460	0	1	3	0	4
11461	0	3	2	0	5
11462	0	0	0	1	1
11463	0	0	1	1	2
11464	0	0	2	0	2
11465	0	0	4	0	4
11466	0	0	1	0	1
11468	0	1	1	0	2
11469	0	2	3	0	5
11471	0	1	0	0	1
11472	0	0	3	0	3
11473	0	0	1	0	1
11474	0	1	2	0	3
11475	0	1	0	1	2
11476	0	0	2	0	2
11477	0	0	2	0	2
11478	0	1	3	0	4
11479	0	2	1	0	3
11480	0	2	1	0	3
11481	0	3	1	0	4
11482	0	3	0	0	3
11483	0	1	1	0	2
11484	0	1	1	2	4
11485	0	1	0	0	1
11486	0	0	1	0	1
11487	0	1	1	0	2
11488	0	2	2	0	4
11489	0	1	2	0	3
11490	0	1	0	0	1
11491	0	1	1	0	2
11492	0	2	1	0	3
11493	0	1	2	0	3
11494	0	2	0	1	3
11496	0	0	1	1	2
11497	0	0	1	0	1
11498	0	1	0	0	1
11499	0	1	2	1	4
11500	0	1	0	0	1
11501	0	1	0	1	2
11502	0	1	1	1	3
11504	0	0	1	0	1
11505	0	1	0	0	1
11506	0	0	1	0	1
11507	0	1	0	0	1
11508	0	3	0	0	3
11509	0	2	0	1	3
11510	0	0	4	2	6
11511	0	2	1	1	4
11512	0	0	2	0	2
11513	0	1	2	0	3
11514	0	1	0	0	1
11516	0	0	1	2	3
11517	0	1	1	0	2
11518	0	0	2	1	3
11519	0	1	2	1	4
11520	0	1	0	0	1
11521	0	1	0	0	1
11522	0	1	3	1	5
11523	0	3	0	1	4
11525	0	0	1	0	1
11527	0	2	1	0	3
11528	0	2	3	0	5
11529	0	0	0	1	1
11531	0	0	2	0	2
11532	0	0	2	0	2
11533	0	1	2	0	3
11534	0	2	1	0	3
11535	0	1	1	1	3
11536	0	1	5	1	7
11537	0	1	0	0	1
11538	0	1	1	3	5
11539	0	1	0	0	1
11540	0	2	0	1	3
11541	0	0	1	0	1
11545	0	1	0	0	1
11546	0	0	1	0	1
11547	0	1	2	0	3
11548	0	2	0	1	3
11549	0	1	1	0	2
11550	0	0	1	0	1
11551	0	2	2	0	4
11552	0	3	2	0	5
11553	0	0	2	2	4
11554	0	3	1	1	5
11556	0	2	3	1	6
11557	0	1	1	1	3
11558	0	2	2	0	4
11559	0	2	3	0	5
11560	0	2	0	0	2
11561	0	3	1	0	4
11562	0	0	1	0	1
11563	0	2	0	1	3
11564	0	1	2	0	3
11566	0	2	1	1	4
11567	0	2	0	0	2
11568	0	1	1	0	2
11569	0	3	0	1	4
11570	0	0	1	0	1
11571	0	0	1	0	1
11572	0	3	0	0	3
11573	0	1	2	0	3
11574	0	2	2	1	5
11575	0	0	1	1	2
11576	0	1	2	0	3
11577	0	2	2	0	4
11578	0	2	1	0	3
11579	0	1	0	0	1
11580	0	0	1	0	1
11581	0	2	1	0	3
11582	0	0	1	0	1
11583	0	2	1	0	3
11584	0	0	1	1	2
11585	0	1	1	0	2
11586	0	1	1	0	2
11587	0	1	2	0	3
11588	0	1	3	0	4
11589	0	0	1	0	1
11590	0	1	3	1	5
11591	0	1	1	1	3
11592	0	1	0	0	1
11593	0	0	1	0	1
11594	0	1	0	0	1
11596	0	2	1	0	3
11597	0	4	1	0	5
11598	0	2	1	1	4
11599	0	2	1	0	3
11600	0	1	1	0	2
11601	0	3	1	0	4
11602	0	1	0	2	3
11603	0	2	1	1	4
11604	0	1	3	0	4
11605	0	2	0	0	2
11606	0	2	1	0	3
11607	0	0	2	0	2
11608	0	1	3	0	4
11609	0	1	1	1	3
11612	0	2	3	0	5
11613	0	2	4	0	6
11614	0	5	0	0	5
11615	0	2	1	1	4
11616	0	1	3	0	4
11617	0	0	1	0	1
11618	0	1	0	0	1
11619	0	3	2	1	6
11620	0	0	2	0	2
11621	0	0	1	0	1
11622	0	0	2	0	2
11623	0	1	1	0	2
11624	0	1	2	0	3
11625	0	0	1	0	1
11626	0	1	1	0	2
11627	0	2	1	0	3
11628	0	0	2	0	2
11629	0	0	4	0	4
11630	0	1	0	0	1
11631	0	0	1	0	1
11632	0	3	0	0	3
11633	0	1	0	1	2
11634	0	0	1	0	1
11636	0	1	1	0	2
11637	0	3	1	0	4
11638	0	0	3	0	3
11639	0	2	1	1	4
11640	0	0	0	1	1
11641	0	4	0	0	4
11642	0	1	2	0	3
11643	0	3	1	1	5
11644	0	0	2	0	2
11645	0	0	1	1	2
11646	0	1	0	0	1
11647	0	0	0	1	1
11648	0	2	1	2	5
11649	0	1	1	0	2
11650	0	1	1	0	2
11651	0	0	2	1	3
11652	0	0	1	0	1
11653	0	2	0	0	2
11654	0	1	0	0	1
11655	0	0	1	0	1
11656	0	2	1	0	3
11658	0	1	1	0	2
11659	0	1	0	0	1
11660	0	1	0	0	1
11661	0	1	2	1	4
11662	0	0	3	0	3
11663	0	1	0	0	1
11664	0	0	1	0	1
11665	0	3	0	0	3
11666	0	3	1	0	4
11667	0	1	3	1	5
11668	0	3	1	0	4
11669	0	1	0	1	2
11670	0	1	2	1	4
11671	0	1	3	0	4
11672	0	2	0	0	2
11673	0	3	2	0	5
11676	0	1	1	0	2
11677	0	0	1	1	2
11678	0	0	3	0	3
11679	0	0	1	0	1
11680	0	0	1	0	1
11681	0	1	0	1	2
11682	0	0	2	0	2
11683	0	0	1	0	1
11684	0	1	0	0	1
11686	0	2	1	0	3
11687	0	1	0	0	1
11688	0	1	2	0	3
11689	0	0	1	1	2
11690	0	0	2	0	2
11691	0	1	1	0	2
11692	0	1	3	1	5
11693	0	0	0	1	1
11694	0	2	0	1	3
11695	0	2	0	2	4
11696	0	1	0	0	1
11697	0	0	1	0	1
11698	0	0	1	1	2
11699	0	2	1	2	5
11700	0	1	1	0	2
11701	0	0	2	0	2
11702	0	0	2	0	2
11703	0	1	0	0	1
11705	0	1	1	0	2
11707	0	1	1	0	2
11708	0	1	0	0	1
11709	0	2	1	0	3
11710	0	3	1	0	4
11711	0	1	0	0	1
11712	0	0	1	0	1
11713	0	0	1	0	1
11714	0	0	1	0	1
11716	0	0	1	0	1
11717	0	0	1	0	1
11718	0	1	1	0	2
11719	0	1	2	1	4
11720	0	2	3	0	5
11721	0	2	2	0	4
11722	0	1	2	1	4
11723	0	1	1	0	2
11725	0	1	2	1	4
11726	0	2	0	0	2
11727	0	0	3	0	3
11728	0	0	1	0	1
11729	0	0	1	0	1
11731	0	0	4	0	4
11732	0	1	0	0	1
11733	0	2	1	1	4
11734	0	1	0	1	2
11735	0	1	1	0	2
11736	0	0	0	1	1
11737	0	2	3	1	6
11738	0	1	2	1	4
11740	0	1	0	0	1
11742	0	0	1	0	1
11743	0	0	2	0	2
11744	0	1	0	0	1
11745	0	1	1	0	2
11746	0	1	2	0	3
11747	0	1	1	0	2
11748	0	0	1	0	1
11749	0	1	1	0	2
11750	0	0	0	1	1
11751	0	0	2	0	2
11752	0	0	0	1	1
11754	0	1	0	0	1
11755	0	0	0	1	1
11756	0	0	2	0	2
11757	0	0	2	1	3
11758	0	1	2	0	3
11759	0	0	2	1	3
11760	0	1	0	0	1
11761	0	3	1	0	4
11762	0	1	1	0	2
11764	0	0	1	0	1
11766	0	2	3	0	5
11767	0	0	2	0	2
11768	0	1	3	0	4
11769	0	1	2	1	4
11770	0	1	0	0	1
11771	0	3	2	0	5
11772	0	0	2	0	2
11773	0	0	1	0	1
11774	0	0	1	1	2
11775	0	0	2	2	4
11776	0	3	2	1	6
11777	0	1	1	0	2
11778	0	0	1	0	1
11779	0	0	3	1	4
11780	0	0	0	2	2
11781	0	2	0	2	4
11782	0	3	0	2	5
11783	0	1	0	1	2
11784	0	1	0	1	2
11785	0	0	1	0	1
11786	0	0	3	1	4
11787	0	0	2	0	2
11788	0	1	2	1	4
11789	0	0	2	0	2
11790	0	1	1	1	3
11791	0	1	2	1	4
11792	0	0	1	0	1
11793	0	0	1	1	2
11794	0	3	1	1	5
11795	0	2	2	1	5
11796	0	0	1	0	1
11798	0	1	1	0	2
11799	0	1	1	0	2
11800	0	2	0	0	2
11801	0	1	2	0	3
11802	0	1	0	0	1
11803	0	1	1	0	2
11804	0	1	1	0	2
11805	0	1	3	0	4
11806	0	0	1	4	5
11807	0	2	3	0	5
11808	0	0	1	0	1
11809	0	1	0	0	1
11810	0	1	1	0	2
11811	0	2	0	0	2
11812	0	0	0	2	2
11813	0	1	0	0	1
11814	0	1	1	1	3
11815	0	1	0	0	1
11816	0	1	0	0	1
11817	0	1	1	1	3
11818	0	0	1	1	2
11819	0	1	1	0	2
11820	0	0	1	0	1
11821	0	1	0	0	1
11822	0	2	0	0	2
11823	0	1	0	0	1
11824	0	0	1	0	1
11825	0	1	1	0	2
11826	0	0	3	0	3
11828	0	1	2	0	3
11829	0	0	1	0	1
11830	0	2	1	1	4
11831	0	1	1	0	2
11832	0	1	0	0	1
11833	0	0	1	0	1
11834	0	2	0	0	2
11835	0	2	1	0	3
11836	0	1	0	0	1
11837	0	1	1	0	2
11838	0	1	1	2	4
11839	0	4	0	0	4
11840	0	1	2	0	3
11842	0	0	1	1	2
11843	0	1	4	1	6
11844	0	2	0	0	2
11846	0	1	2	0	3
11847	0	1	2	1	4
11848	0	2	1	0	3
11849	0	1	2	1	4
11850	0	1	2	0	3
11851	0	0	1	0	1
11852	0	1	1	0	2
11853	0	0	0	1	1
11854	0	0	1	1	2
11855	0	1	1	1	3
11856	0	0	3	0	3
11857	0	1	1	0	2
11858	0	0	1	0	1
11859	0	0	1	1	2
11860	0	1	0	0	1
11861	0	1	2	0	3
11862	0	0	4	1	5
11863	0	1	1	0	2
11864	0	1	0	0	1
11865	0	0	1	0	1
11867	0	2	0	1	3
11869	0	0	1	0	1
11870	0	1	0	0	1
11871	0	1	2	0	3
11872	0	1	0	0	1
11873	0	0	2	0	2
11874	0	0	1	0	1
11875	0	0	0	1	1
11876	0	1	1	0	2
11877	0	2	2	1	5
11878	0	1	0	0	1
11879	0	0	3	0	3
11880	0	0	1	0	1
11881	0	0	1	2	3
11882	0	1	2	0	3
11883	0	0	1	0	1
11884	0	1	1	0	2
11885	0	0	3	1	4
11886	0	0	0	2	2
11887	0	0	1	1	2
11888	0	1	1	0	2
11889	0	1	0	0	1
11890	0	1	0	0	1
11892	0	0	1	0	1
11893	0	1	1	0	2
11894	0	0	1	0	1
11895	0	1	1	0	2
11897	0	0	0	1	1
11898	0	1	1	0	2
11899	0	1	0	1	2
11900	0	1	2	2	5
11901	0	0	2	1	3
11902	0	0	1	0	1
11903	0	2	0	1	3
11904	0	1	1	0	2
11905	0	0	0	1	1
11906	0	1	1	0	2
11907	0	1	0	0	1
11908	0	1	0	1	2
11909	0	1	2	1	4
11910	0	1	1	1	3
11911	0	2	0	0	2
11912	0	1	1	0	2
11913	0	3	2	1	6
11914	0	2	0	1	3
11916	0	0	1	0	1
11917	0	1	2	0	3
11918	0	1	1	0	2
11919	0	2	0	0	2
11920	0	1	0	1	2
11922	0	2	2	0	4
11924	0	1	0	0	1
11925	0	3	1	0	4
11926	0	1	1	0	2
11927	0	1	1	0	2
11928	0	0	1	0	1
11929	0	0	1	0	1
11930	0	2	0	2	4
11931	0	0	2	0	2
11932	0	0	1	0	1
11933	0	1	0	0	1
11934	0	2	2	0	4
11935	0	0	1	0	1
11936	0	1	1	1	3
11937	0	0	3	0	3
11938	0	1	2	0	3
11940	0	2	0	0	2
11941	0	1	0	0	1
11942	0	4	1	0	5
11943	0	2	2	0	4
11944	0	0	1	0	1
11945	0	0	1	0	1
11946	0	1	2	1	4
11949	0	1	1	1	3
11950	0	1	1	0	2
11951	0	2	1	0	3
11952	0	2	0	1	3
11953	0	1	2	0	3
11954	0	2	0	1	3
11955	0	3	1	0	4
11956	0	0	3	1	4
11957	0	0	3	0	3
11958	0	1	0	1	2
11959	0	1	3	2	6
11960	0	0	1	1	2
11961	0	1	1	0	2
11962	0	1	3	1	5
11963	0	0	1	0	1
11964	0	0	2	0	2
11965	0	0	2	1	3
11966	0	0	3	0	3
11967	0	0	1	0	1
11968	0	3	0	0	3
11969	0	0	3	1	4
11970	0	0	1	0	1
11971	0	0	2	0	2
11972	0	0	1	0	1
11973	0	3	1	1	5
11976	0	1	1	0	2
11977	0	0	1	2	3
11978	0	1	1	1	3
11979	0	0	1	1	2
11980	0	0	0	1	1
11981	0	2	2	0	4
11983	0	1	1	0	2
11984	0	0	2	0	2
11986	0	1	1	0	2
11987	0	3	0	1	4
11988	0	1	1	0	2
11989	0	1	0	0	1
11990	0	2	2	1	5
11991	0	2	0	0	2
11992	0	0	2	0	2
11993	0	1	2	1	4
11994	0	0	1	1	2
11995	0	1	3	0	4
11996	0	1	3	0	4
11997	0	0	0	1	1
11998	0	1	2	0	3
11999	0	0	1	0	1
12000	0	1	1	1	3
12001	0	0	1	0	1
12002	0	2	1	2	5
12003	0	0	1	0	1
12004	0	1	1	0	2
12006	0	0	0	2	2
12007	0	1	0	0	1
12009	0	0	1	0	1
12010	0	1	0	0	1
12012	0	1	1	1	3
12013	0	2	2	0	4
12016	0	1	1	1	3
12017	0	2	1	0	3
12018	0	1	1	0	2
12019	0	1	1	1	3
12020	0	2	0	1	3
12021	0	0	2	0	2
12022	0	1	0	0	1
12023	0	1	1	1	3
12024	0	0	0	1	1
12025	0	2	2	0	4
12026	0	1	1	1	3
12027	0	2	2	0	4
12028	0	0	2	0	2
12029	0	1	2	0	3
12030	0	0	1	1	2
12031	0	1	2	1	4
12032	0	0	1	0	1
12033	0	1	0	1	2
12034	0	1	1	0	2
12036	0	1	0	0	1
12037	0	1	1	0	2
12038	0	0	0	1	1
12040	0	1	1	1	3
12042	0	1	1	1	3
12043	0	1	2	0	3
12045	0	2	0	0	2
12047	0	1	0	0	1
12048	0	1	1	0	2
12049	0	0	2	0	2
12050	0	0	0	1	1
12051	0	0	1	0	1
12052	0	0	1	0	1
12053	0	0	1	1	2
12054	0	1	1	0	2
12055	0	0	1	1	2
12056	0	1	1	0	2
12057	0	0	1	0	1
12058	0	2	0	0	2
12059	0	0	1	1	2
12060	0	1	0	2	3
12061	0	2	0	1	3
12063	0	0	3	0	3
12064	0	0	1	0	1
12065	0	1	1	0	2
12066	0	0	1	0	1
12067	0	1	0	2	3
12068	0	0	0	1	1
12069	0	1	0	0	1
12070	0	0	1	0	1
12071	0	3	0	1	4
12072	0	0	3	0	3
12073	0	0	0	2	2
12074	0	2	1	0	3
12075	0	0	0	1	1
12078	0	0	3	0	3
12079	0	0	1	0	1
12080	0	1	1	0	2
12081	0	0	1	0	1
12082	0	1	0	0	1
12084	0	5	1	1	7
12085	0	1	3	0	4
12086	0	1	0	0	1
12087	0	1	0	0	1
12088	0	0	1	0	1
12089	0	3	3	0	6
12090	0	0	2	0	2
12091	0	1	0	0	1
12092	0	0	4	0	4
12093	0	2	2	0	4
12094	0	0	1	0	1
12095	0	0	1	0	1
12096	0	0	0	1	1
12097	0	0	2	0	2
12098	0	1	0	0	1
12099	0	0	1	0	1
12100	0	2	0	0	2
12101	0	0	4	0	4
12102	0	2	1	0	3
12104	0	0	0	1	1
12105	0	2	2	0	4
12106	0	0	1	1	2
12107	0	0	1	0	1
12108	0	4	0	1	5
12109	0	2	2	0	4
12110	0	1	2	0	3
12111	0	1	2	0	3
12113	0	1	1	0	2
12114	0	2	1	0	3
12117	0	0	1	1	2
12120	0	0	1	1	2
12121	0	2	3	0	5
12122	0	1	0	0	1
12123	0	3	1	0	4
12124	0	1	1	0	2
12125	0	1	1	1	3
12127	0	0	2	0	2
12130	0	2	0	0	2
12131	0	0	1	0	1
12132	0	0	1	0	1
12133	0	0	2	0	2
12134	0	1	0	0	1
12135	0	3	0	0	3
12136	0	1	1	1	3
12137	0	0	1	0	1
12138	0	1	1	0	2
12139	0	2	2	0	4
12141	0	2	2	1	5
12142	0	1	1	0	2
12143	0	2	0	1	3
12145	0	1	0	1	2
12146	0	1	0	0	1
12147	0	1	0	0	1
12148	0	0	1	0	1
12149	0	1	1	0	2
12152	0	0	2	0	2
12153	0	1	2	0	3
12154	1	0	0	0	1
12155	0	0	3	0	3
12156	0	0	1	0	1
12157	0	1	0	0	1
12159	0	2	0	0	2
12160	0	2	0	0	2
12161	0	1	0	0	1
12162	0	1	0	1	2
12163	0	0	1	1	2
12164	0	0	1	1	2
12166	0	1	1	0	2
12167	0	0	2	0	2
12168	0	2	2	0	4
12169	0	0	1	0	1
12170	0	0	1	0	1
12171	0	0	1	0	1
12172	0	2	1	0	3
12173	0	0	0	1	1
12174	0	3	0	0	3
12175	0	1	0	0	1
12176	0	0	1	0	1
12177	0	1	1	1	3
12178	0	0	0	1	1
12179	0	1	2	1	4
12180	0	0	1	0	1
12181	0	1	2	0	3
12182	0	2	1	0	3
12183	0	0	1	0	1
12184	0	0	1	0	1
12185	0	0	2	0	2
12186	0	1	1	0	2
12187	0	1	1	0	2
12188	0	0	1	1	2
12189	0	1	0	0	1
12190	0	1	1	0	2
12191	0	0	2	0	2
12192	0	1	1	0	2
12193	0	0	0	1	1
12195	0	1	3	0	4
12196	0	1	0	0	1
12198	0	0	2	0	2
12200	0	1	0	1	2
12202	0	1	0	0	1
12203	0	0	0	1	1
12204	0	3	0	1	4
12205	0	1	1	0	2
12206	0	2	1	0	3
12207	0	0	1	0	1
12208	0	0	2	0	2
12209	0	0	1	0	1
12210	0	0	0	1	1
12212	0	1	0	0	1
12213	0	1	0	1	2
12214	0	0	1	0	1
12215	0	2	1	0	3
12216	0	1	4	0	5
12217	0	1	1	1	3
12218	0	1	2	0	3
12219	0	0	1	0	1
12220	0	1	0	1	2
12221	0	1	0	0	1
12222	0	0	1	1	2
12223	0	1	1	0	2
12225	0	0	3	0	3
12227	0	1	2	0	3
12228	0	0	1	0	1
12229	0	1	0	0	1
12230	0	2	1	0	3
12231	0	2	1	0	3
12233	0	1	1	0	2
12234	0	1	1	0	2
12235	0	0	0	1	1
12237	0	2	1	0	3
12238	0	2	0	1	3
12240	0	0	4	0	4
12241	0	0	1	0	1
12242	0	2	0	0	2
12243	0	1	0	0	1
12245	0	2	0	0	2
12246	0	0	2	0	2
12247	0	0	0	1	1
12248	0	2	1	0	3
12249	0	0	3	0	3
12250	0	1	1	0	2
12251	0	0	2	0	2
12252	0	1	3	1	5
12253	0	1	0	0	1
12255	0	2	2	1	5
12256	0	0	1	0	1
12257	0	1	1	0	2
12258	0	0	2	1	3
12259	0	0	1	0	1
12260	0	0	1	0	1
12261	0	0	2	0	2
12263	0	1	2	0	3
12264	0	1	0	1	2
12266	0	0	1	1	2
12267	0	1	1	0	2
12268	0	0	1	0	1
12269	0	1	2	0	3
12270	0	0	2	0	2
12271	0	0	1	0	1
12272	0	1	1	0	2
12273	0	1	1	0	2
12274	0	0	2	0	2
12275	0	0	0	1	1
12276	0	1	3	0	4
12280	0	0	2	1	3
12282	0	1	0	0	1
12283	0	2	1	0	3
12284	0	0	1	0	1
12285	0	0	3	0	3
12286	0	0	2	0	2
12288	0	2	0	0	2
12290	0	0	1	1	2
12291	0	0	1	2	3
12292	0	0	2	1	3
12293	0	1	0	0	1
12296	0	3	0	0	3
12297	0	0	0	1	1
12298	0	0	1	1	2
12299	0	1	1	0	2
12300	0	0	3	0	3
12303	0	0	3	0	3
12305	0	1	0	0	1
12306	0	0	2	0	2
12308	0	1	1	2	4
12310	0	1	0	0	1
12311	0	1	0	1	2
12312	0	1	1	0	2
12313	0	1	0	0	1
12314	0	1	0	0	1
12315	0	0	1	1	2
12316	0	1	1	1	3
12317	0	1	1	0	2
12319	0	0	1	0	1
12320	0	1	0	0	1
12321	0	1	1	0	2
12322	0	1	0	0	1
12323	0	0	1	0	1
12324	0	0	2	0	2
12325	0	1	1	0	2
12326	0	1	2	0	3
12327	0	1	3	0	4
12328	0	1	2	0	3
12330	0	0	1	1	2
12331	0	1	1	0	2
12332	0	0	1	1	2
12333	0	1	2	0	3
12334	0	2	1	0	3
12336	0	2	3	0	5
12337	0	1	1	0	2
12339	0	0	1	1	2
12341	0	3	1	0	4
12342	0	3	2	0	5
12347	0	1	1	0	2
12348	0	0	1	1	2
12349	0	3	2	0	5
12350	0	2	2	0	4
12351	0	1	1	0	2
12352	0	1	1	0	2
12353	0	2	0	1	3
12354	0	0	2	0	2
12355	0	0	1	0	1
12356	0	0	1	0	1
12357	0	0	1	1	2
12358	0	1	1	1	3
12359	0	2	1	0	3
12360	0	1	2	0	3
12361	0	0	2	0	2
12362	0	1	0	0	1
12363	0	0	2	0	2
12365	0	1	1	0	2
12366	0	0	1	0	1
12367	0	1	2	0	3
12368	0	1	0	0	1
12369	0	1	2	0	3
12370	0	0	1	0	1
12372	0	1	0	0	1
12373	0	0	1	0	1
12375	0	1	0	0	1
12376	0	3	1	0	4
12377	0	0	0	1	1
12378	0	2	1	0	3
12379	0	3	1	0	4
12380	0	2	0	1	3
12381	0	0	1	0	1
12382	0	1	0	0	1
12383	0	0	2	0	2
12386	0	0	1	1	2
12387	0	0	2	0	2
12388	0	0	1	0	1
12389	0	1	1	0	2
12390	0	0	2	0	2
12391	0	0	1	1	2
12392	0	1	0	0	1
12393	0	0	0	1	1
12394	0	0	2	0	2
12395	0	0	0	1	1
12396	0	0	3	0	3
12397	0	0	2	2	4
12398	0	0	1	0	1
12399	0	0	1	1	2
12401	0	1	0	0	1
12403	0	1	0	0	1
12404	0	1	3	0	4
12405	0	0	1	0	1
12406	0	1	0	1	2
12407	0	0	1	1	2
12408	0	0	1	1	2
12409	0	1	1	0	2
12410	0	1	0	0	1
12411	0	1	1	0	2
12412	0	0	2	0	2
12414	0	0	1	0	1
12415	0	0	1	1	2
12416	0	1	0	0	1
12417	0	0	2	0	2
12418	0	1	0	0	1
12419	0	0	0	1	1
12420	0	2	0	0	2
12421	0	1	1	0	2
12422	0	1	1	0	2
12423	0	0	1	1	2
12424	0	0	2	0	2
12425	0	1	1	0	2
12427	0	2	0	0	2
12428	0	0	1	1	2
12429	0	0	1	0	1
12430	0	0	2	0	2
12432	0	0	1	0	1
12434	0	1	2	0	3
12435	0	0	2	0	2
12436	0	0	1	0	1
12437	0	0	1	0	1
12438	0	1	1	0	2
12439	0	0	3	0	3
12440	0	1	0	0	1
12441	0	1	1	0	2
12442	0	0	1	1	2
12443	0	1	1	0	2
12444	0	2	0	1	3
12445	0	1	0	0	1
12446	0	0	1	0	1
12447	0	1	1	0	2
12448	0	2	1	0	3
12449	0	2	1	0	3
12450	0	0	1	1	2
12451	0	1	0	0	1
12452	0	2	0	1	3
12453	0	2	1	0	3
12454	0	0	1	1	2
12456	0	0	0	1	1
12457	0	0	3	0	3
12458	0	2	0	1	3
12459	0	0	2	0	2
12462	0	1	0	0	1
12463	0	0	1	1	2
12464	0	1	0	0	1
12465	0	1	0	0	1
12466	0	1	1	0	2
12467	0	2	0	0	2
12469	0	1	1	0	2
12470	0	2	0	0	2
12471	0	1	1	0	2
12472	0	1	0	1	2
12473	0	1	1	0	2
12474	0	0	1	0	1
12475	0	1	1	0	2
12476	0	0	1	0	1
12477	0	1	1	1	3
12478	0	0	1	0	1
12479	0	1	0	0	1
12480	0	1	0	1	2
12481	0	0	2	0	2
12482	0	1	0	0	1
12483	0	1	2	0	3
12485	0	1	0	0	1
12486	0	1	1	0	2
12488	0	0	1	1	2
12489	0	0	2	0	2
12490	0	0	2	0	2
12491	0	2	0	0	2
12492	0	0	1	0	1
12494	0	0	1	0	1
12495	0	0	2	0	2
12497	0	0	1	0	1
12498	0	1	0	1	2
12500	0	1	1	0	2
12501	0	0	1	0	1
12502	0	1	1	0	2
12504	0	1	0	1	2
12505	0	0	1	0	1
12506	0	0	1	0	1
12509	0	1	3	0	4
12510	0	1	2	1	4
12511	0	2	0	0	2
12513	0	1	1	0	2
12514	0	1	2	0	3
12516	0	1	0	0	1
12517	0	1	1	0	2
12518	0	1	1	0	2
12519	0	0	1	0	1
12520	0	1	0	0	1
12521	0	0	2	0	2
12523	0	1	0	0	1
12524	0	0	1	0	1
12525	0	3	0	0	3
12526	0	1	1	0	2
12527	0	0	2	0	2
12528	0	2	2	0	4
12529	0	0	0	1	1
12531	0	0	1	0	1
12532	0	0	2	0	2
12533	0	3	3	0	6
12535	0	1	1	0	2
12536	0	0	1	0	1
12537	0	0	2	0	2
12538	0	2	0	0	2
12539	0	1	2	0	3
12540	0	2	0	0	2
12541	0	1	0	0	1
12543	0	1	1	0	2
12544	0	2	1	0	3
12545	0	2	0	0	2
12546	0	1	1	0	2
12547	0	1	2	0	3
12548	0	1	1	0	2
12550	0	2	0	0	2
12551	0	0	1	0	1
12552	0	0	1	0	1
12553	0	1	0	0	1
12555	0	0	1	1	2
12556	0	1	1	0	2
12557	0	1	1	1	3
12558	0	0	1	0	1
12559	0	1	0	0	1
12560	0	2	0	1	3
12563	0	0	1	0	1
12566	0	0	2	0	2
12567	0	3	1	0	4
12568	0	1	0	0	1
12569	0	1	1	0	2
12570	0	1	0	0	1
12571	0	0	1	0	1
12573	0	1	1	0	2
12574	0	1	1	0	2
12575	0	1	1	0	2
12576	0	2	0	0	2
12577	0	2	1	1	4
12578	0	0	2	1	3
12579	0	0	2	0	2
12581	0	0	1	1	2
12582	0	0	1	0	1
12583	0	0	1	0	1
12584	0	1	2	1	4
12585	0	0	1	0	1
12586	0	0	1	0	1
12588	0	1	1	0	2
12589	0	0	0	1	1
12592	0	1	0	2	3
12593	0	0	1	1	2
12594	0	1	0	0	1
12595	0	2	0	0	2
12597	0	1	0	0	1
12599	0	1	1	1	3
12601	0	0	1	0	1
12602	0	2	0	0	2
12603	0	0	3	1	4
12604	0	2	2	1	5
12605	0	0	1	0	1
12606	0	1	0	0	1
12607	0	0	1	0	1
12608	0	1	3	0	4
12609	0	0	1	0	1
12610	0	0	1	0	1
12611	0	1	1	0	2
12613	0	0	1	0	1
12614	0	0	0	1	1
12615	0	0	3	0	3
12616	0	0	1	0	1
12617	0	0	1	0	1
12618	0	0	1	0	1
12619	0	4	0	0	4
12620	0	0	1	0	1
12621	0	0	1	0	1
12622	0	1	0	0	1
12625	0	2	0	0	2
12626	0	1	0	0	1
12627	0	1	2	1	4
12628	0	0	2	0	2
12629	0	2	0	0	2
12630	0	1	0	0	1
12631	0	1	2	0	3
12632	0	1	1	0	2
12633	0	0	1	0	1
12634	0	1	0	0	1
12635	0	0	1	1	2
12637	0	0	3	2	5
12639	0	1	2	0	3
12640	0	1	0	0	1
12641	0	3	1	0	4
12645	0	0	2	0	2
12646	0	0	1	0	1
12647	0	0	2	0	2
12648	0	1	2	0	3
12649	0	0	3	0	3
12650	0	1	1	0	2
12652	0	1	0	0	1
12653	0	1	0	0	1
12654	0	0	1	0	1
12655	0	1	1	0	2
12656	0	0	0	1	1
12657	0	1	1	0	2
12658	0	1	0	0	1
12660	0	0	2	0	2
12661	0	0	2	0	2
12663	0	0	1	0	1
12665	0	1	1	0	2
12666	0	1	1	0	2
12667	0	0	1	0	1
12668	0	0	1	0	1
12669	0	1	3	0	4
12670	0	0	1	0	1
12671	0	3	1	0	4
12672	0	0	0	2	2
12673	0	2	0	1	3
12674	0	1	0	0	1
12675	0	1	0	0	1
12678	0	1	2	1	4
12679	0	1	1	0	2
12682	0	2	3	1	6
12683	0	0	1	0	1
12684	0	1	1	1	3
12685	0	2	0	0	2
12687	0	0	1	0	1
12688	0	1	1	0	2
12689	0	1	2	0	3
12690	0	1	0	0	1
12691	0	1	4	0	5
12692	0	1	0	0	1
12693	0	0	2	0	2
12694	0	1	1	0	2
12695	0	1	1	0	2
12696	0	1	0	0	1
12697	0	2	1	2	5
12698	0	0	1	1	2
12699	0	1	2	0	3
12701	0	0	0	1	1
12702	0	0	1	0	1
12703	0	1	1	0	2
12705	0	1	3	0	4
12706	0	0	1	0	1
12707	0	0	0	1	1
12708	0	1	0	0	1
12709	0	2	0	1	3
12710	0	0	0	1	1
12711	0	0	1	0	1
12713	0	0	0	1	1
12714	0	1	0	0	1
12715	0	1	0	1	2
12716	0	1	4	0	5
12717	0	0	3	0	3
12718	0	1	0	0	1
12719	0	0	1	1	2
12720	0	1	1	0	2
12721	0	1	2	0	3
12723	0	1	0	0	1
12724	0	1	0	1	2
12725	0	1	0	0	1
12726	0	2	1	0	3
12727	0	0	3	0	3
12728	0	1	0	0	1
12729	0	1	2	0	3
12730	0	2	0	0	2
12731	0	0	1	1	2
12732	0	1	2	0	3
12734	0	0	1	0	1
12735	0	1	1	0	2
12736	0	0	1	1	2
12737	0	1	1	0	2
12739	0	0	0	1	1
12741	0	1	0	0	1
12742	0	1	1	1	3
12743	0	1	1	1	3
12744	0	1	1	1	3
12745	0	0	1	0	1
12746	0	1	1	0	2
12747	0	1	0	0	1
12748	0	1	1	0	2
12749	0	0	1	0	1
12750	0	1	0	1	2
12752	0	1	0	0	1
12753	0	1	0	0	1
12755	0	1	0	0	1
12756	0	1	0	0	1
12757	0	1	0	0	1
12758	0	1	0	0	1
12759	0	0	1	1	2
12760	0	0	0	1	1
12761	0	2	1	0	3
12762	0	3	0	0	3
12764	0	1	2	0	3
12765	0	1	0	1	2
12766	0	0	1	0	1
12768	0	0	1	0	1
12773	0	0	1	0	1
12774	0	1	0	1	2
12775	0	1	1	0	2
12776	0	1	2	0	3
12777	0	0	2	0	2
12778	0	2	1	0	3
12779	0	2	1	0	3
12781	0	0	1	0	1
12782	0	0	0	1	1
12785	0	2	2	0	4
12786	0	3	0	0	3
12787	0	0	1	0	1
12788	0	1	2	0	3
12789	0	0	1	1	2
12790	0	1	0	0	1
12792	0	1	0	0	1
12793	0	2	1	0	3
12794	0	2	0	0	2
12797	0	1	1	0	2
12799	0	2	1	1	4
12800	0	1	1	0	2
12802	0	1	0	0	1
12805	0	0	1	0	1
12806	0	2	2	0	4
12807	0	2	0	0	2
12808	0	3	1	0	4
12809	0	3	1	0	4
12810	0	1	1	1	3
12811	0	0	1	0	1
12812	0	0	1	0	1
12813	0	2	2	0	4
12814	0	0	1	0	1
12816	0	0	1	0	1
12817	0	1	1	1	3
12821	0	3	1	0	4
12822	0	1	0	0	1
12823	0	0	0	1	1
12825	0	0	0	1	1
12826	0	1	1	0	2
12827	0	0	0	1	1
12829	0	1	1	0	2
12830	0	0	2	0	2
12831	0	0	1	0	1
12833	0	0	0	1	1
12834	0	1	0	0	1
12836	0	1	1	0	2
12839	0	1	3	0	4
12840	0	1	0	0	1
12841	0	0	1	0	1
12843	0	1	0	0	1
12844	0	0	1	0	1
12845	0	0	0	1	1
12846	0	0	1	1	2
12847	0	1	1	0	2
12848	0	0	1	0	1
12849	0	1	3	0	4
12850	0	1	0	0	1
12851	0	0	2	0	2
12852	0	2	1	1	4
12853	0	2	1	0	3
12854	0	1	0	0	1
12855	0	1	1	0	2
12856	0	0	1	1	2
12857	0	0	1	1	2
12858	0	0	1	0	1
12860	0	0	0	2	2
12861	0	0	2	0	2
12862	0	0	2	0	2
12863	0	1	2	0	3
12865	0	1	0	1	2
12866	0	0	2	0	2
12867	0	1	2	0	3
12868	0	1	1	0	2
12869	0	2	1	0	3
12870	0	1	0	0	1
12871	0	0	1	0	1
12872	0	0	2	0	2
12873	0	1	1	0	2
12874	0	1	0	0	1
12875	0	1	0	0	1
12876	0	2	3	1	6
12877	0	0	2	0	2
12878	0	1	1	0	2
12879	0	0	1	1	2
12881	0	0	1	1	2
12886	0	2	0	0	2
12887	0	3	1	0	4
12888	0	1	0	0	1
12889	0	0	0	1	1
12891	0	1	0	0	1
12892	0	0	1	0	1
12893	0	1	0	0	1
12895	0	1	0	1	2
12896	0	0	1	0	1
12897	0	1	0	0	1
12898	0	0	0	1	1
12899	0	0	1	0	1
12900	0	0	1	0	1
12901	0	0	1	0	1
12902	0	1	3	0	4
12903	0	2	0	0	2
12904	0	0	3	1	4
12909	0	1	0	0	1
12911	0	0	1	0	1
12912	0	1	1	0	2
12913	0	2	0	0	2
12915	0	0	2	0	2
12916	0	1	1	1	3
12917	0	2	0	0	2
12919	0	0	1	0	1
12921	0	1	2	0	3
12922	0	0	0	1	1
12923	0	1	1	1	3
12924	0	0	1	0	1
12925	0	1	0	0	1
12926	0	0	3	0	3
12927	0	0	1	0	1
12928	0	0	0	1	1
12929	0	0	1	0	1
12930	0	0	1	0	1
12931	0	1	0	0	1
12932	0	2	0	0	2
12933	0	0	1	0	1
12934	0	1	0	0	1
12935	0	1	1	0	2
12936	0	0	2	0	2
12937	0	0	2	0	2
12938	0	0	0	2	2
12939	0	1	2	0	3
12941	0	1	0	1	2
12945	0	0	1	0	1
12946	0	0	2	0	2
12948	0	2	1	0	3
12950	0	1	0	0	1
12952	0	0	1	0	1
12953	0	2	1	1	4
12954	0	0	1	0	1
12955	0	1	1	0	2
12956	0	1	1	0	2
12957	0	0	0	3	3
12959	0	1	1	0	2
12960	0	1	0	0	1
12962	0	2	1	0	3
12963	0	1	0	1	2
12967	0	0	2	0	2
12968	0	0	0	1	1
12970	0	1	1	0	2
12972	0	0	0	1	1
12973	0	0	1	0	1
12975	0	1	0	0	1
12976	0	2	0	1	3
12978	0	1	0	1	2
12979	0	0	0	1	1
12980	0	0	1	0	1
12982	0	2	3	1	6
12983	0	1	0	0	1
12984	0	1	3	0	4
12987	0	0	1	0	1
12988	0	1	2	0	3
12989	0	0	0	2	2
12990	0	0	1	0	1
12991	0	0	1	0	1
12992	0	1	1	0	2
12993	0	0	0	1	1
12994	0	1	1	0	2
12996	0	1	1	1	3
12997	0	1	0	0	1
12998	0	1	2	0	3
12999	0	1	0	0	1
13000	0	2	1	0	3
13003	0	1	1	0	2
13004	0	1	0	1	2
13005	0	1	0	0	1
13006	0	1	1	0	2
13007	0	0	0	1	1
13008	0	0	1	0	1
13010	0	1	1	0	2
13012	0	0	2	0	2
13014	0	3	0	0	3
13015	0	1	1	2	4
13016	0	0	2	0	2
13019	0	0	3	0	3
13020	0	1	1	0	2
13022	0	1	0	1	2
13023	0	0	2	1	3
13024	0	0	1	0	1
13025	0	1	0	0	1
13026	0	1	3	0	4
13027	0	2	0	0	2
13028	0	0	1	0	1
13030	0	1	2	0	3
13031	0	0	0	1	1
13032	0	1	2	0	3
13033	0	0	1	0	1
13035	0	2	1	0	3
13036	0	2	0	0	2
13037	0	0	1	0	1
13038	0	2	1	0	3
13039	0	0	1	0	1
13040	0	0	2	0	2
13041	0	0	0	1	1
13042	0	1	0	1	2
13043	0	1	2	0	3
13044	0	1	1	0	2
13045	0	2	1	0	3
13047	0	1	1	0	2
13050	0	1	0	0	1
13052	0	0	1	0	1
13053	0	0	1	0	1
13054	0	0	0	1	1
13055	0	1	0	0	1
13056	0	1	0	0	1
13059	0	1	2	0	3
13060	0	1	0	0	1
13062	0	1	2	0	3
13065	0	2	1	1	4
13066	0	1	0	0	1
13070	0	1	0	0	1
13073	0	0	0	1	1
13074	0	1	0	0	1
13075	0	1	0	1	2
13077	0	1	0	0	1
13078	0	1	0	0	1
13079	0	0	0	1	1
13080	0	0	2	0	2
13081	0	1	0	0	1
13082	0	0	1	0	1
13083	0	1	1	0	2
13084	0	0	1	0	1
13085	0	1	0	0	1
13086	0	1	2	0	3
13087	0	1	0	0	1
13088	0	0	1	0	1
13089	0	1	2	0	3
13090	0	0	0	1	1
13091	0	1	1	0	2
13092	0	1	1	0	2
13093	0	0	1	0	1
13097	0	0	2	0	2
13099	0	0	1	0	1
13100	0	0	1	0	1
13101	0	0	1	0	1
13103	0	0	1	0	1
13104	0	1	2	0	3
13106	0	0	1	0	1
13108	0	0	1	0	1
13110	0	0	1	1	2
13112	0	0	0	1	1
13114	0	0	1	0	1
13115	0	0	1	1	2
13116	0	1	2	0	3
13117	0	1	1	0	2
13118	0	0	1	0	1
13119	0	1	0	0	1
13120	0	0	1	0	1
13122	0	0	1	0	1
13123	0	1	0	0	1
13124	0	0	1	0	1
13125	0	1	0	0	1
13126	0	1	1	0	2
13127	0	2	0	0	2
13128	0	2	0	0	2
13129	0	0	2	0	2
13130	0	0	1	0	1
13132	0	1	0	0	1
13133	0	0	1	0	1
13136	0	0	1	1	2
13137	0	0	1	0	1
13138	0	0	1	0	1
13140	0	1	1	0	2
13142	0	0	1	0	1
13143	0	1	1	0	2
13144	0	1	0	0	1
13145	0	0	0	1	1
13147	0	1	1	0	2
13148	0	0	1	0	1
13151	0	0	1	0	1
13153	0	2	2	1	5
13155	0	2	0	0	2
13157	0	0	3	0	3
13158	0	0	1	0	1
13161	0	0	0	1	1
13162	0	0	1	0	1
13164	0	1	0	0	1
13166	0	0	2	0	2
13169	0	0	1	0	1
13170	0	1	0	0	1
13171	0	0	1	0	1
13172	0	1	0	0	1
13173	0	0	1	0	1
13174	0	1	2	0	3
13175	0	1	0	0	1
13176	0	0	1	0	1
13181	0	0	1	0	1
13186	0	0	1	0	1
13188	0	1	2	0	3
13190	0	1	0	0	1
13192	0	1	0	0	1
13193	0	2	4	1	7
13196	0	0	2	0	2
13197	0	1	0	0	1
13198	0	1	0	0	1
13199	0	1	1	0	2
13201	0	1	0	0	1
13203	0	1	2	0	3
13204	0	0	1	0	1
13205	0	1	0	1	2
13206	0	0	1	0	1
13207	0	1	0	0	1
13208	0	2	1	0	3
13210	0	0	1	0	1
13211	0	0	3	1	4
13212	0	1	1	0	2
13213	0	1	0	0	1
13215	0	0	1	1	2
13216	0	1	1	0	2
13217	0	1	1	0	2
13218	0	0	1	1	2
13219	0	2	0	0	2
13220	0	2	0	0	2
13221	0	0	1	0	1
13222	0	1	1	0	2
13223	0	2	0	1	3
13224	0	1	3	1	5
13226	0	0	1	0	1
13228	0	0	2	0	2
13229	0	1	1	0	2
13231	0	0	1	0	1
13232	0	0	1	1	2
13234	0	0	2	2	4
13235	0	0	1	0	1
13236	0	0	1	0	1
13237	0	0	1	0	1
13240	0	0	1	0	1
13241	0	1	0	0	1
13242	0	0	1	0	1
13243	0	0	0	1	1
13245	0	1	0	0	1
13247	0	1	0	0	1
13249	0	0	1	0	1
13250	0	1	2	1	4
13251	0	0	1	0	1
13252	0	1	0	1	2
13253	0	1	0	0	1
13254	1	0	0	1	2
13256	0	3	0	0	3
13258	0	1	0	0	1
13259	0	0	2	1	3
13260	0	0	0	1	1
13261	0	0	1	0	1
13262	0	1	1	2	4
13263	0	1	1	0	2
13264	0	2	0	0	2
13267	0	0	1	0	1
13268	0	0	1	0	1
13269	0	0	1	0	1
13270	0	1	0	0	1
13273	0	0	1	0	1
13274	0	1	0	0	1
13275	0	0	2	0	2
13277	0	1	1	0	2
13278	0	1	0	0	1
13280	0	0	1	0	1
13282	0	2	0	0	2
13283	0	0	0	1	1
13284	0	0	3	0	3
13286	0	2	0	1	3
13288	0	0	1	1	2
13291	0	0	2	0	2
13292	0	1	1	1	3
13295	0	0	2	0	2
13297	0	2	0	1	3
13299	0	2	2	1	5
13300	0	1	0	0	1
13301	0	0	3	0	3
13302	0	0	1	1	2
13303	0	0	2	0	2
13305	0	1	1	0	2
13306	0	0	1	0	1
13307	0	0	1	0	1
13308	0	0	4	1	5
13310	0	0	2	0	2
13311	0	1	1	0	2
13312	0	0	2	0	2
13313	0	1	3	0	4
13314	0	1	2	0	3
13315	0	0	1	0	1
13316	0	3	0	0	3
13317	0	1	0	0	1
13319	0	1	0	0	1
13321	0	0	1	0	1
13322	0	1	0	0	1
13323	0	0	0	1	1
13324	0	1	0	0	1
13326	0	1	2	1	4
13327	0	1	0	0	1
13328	0	1	1	0	2
13329	0	1	2	0	3
13333	0	0	0	1	1
13334	0	1	0	0	1
13336	0	1	1	0	2
13338	0	0	1	0	1
13341	0	1	0	0	1
13343	0	0	1	0	1
13344	0	0	1	0	1
13347	0	1	1	0	2
13348	0	1	0	0	1
13349	0	1	0	0	1
13350	0	0	2	0	2
13351	0	1	0	0	1
13353	0	0	0	1	1
13356	0	1	1	1	3
13358	0	0	1	0	1
13359	0	1	2	1	4
13361	0	1	1	0	2
13362	0	0	2	0	2
13365	0	2	0	0	2
13366	0	1	1	0	2
13367	0	1	0	0	1
13369	0	1	1	0	2
13373	0	0	2	0	2
13374	0	1	0	0	1
13375	0	0	2	0	2
13376	0	2	2	1	5
13378	0	1	0	2	3
13379	0	0	1	1	2
13380	0	1	0	0	1
13381	0	1	0	1	2
13382	0	1	0	0	1
13383	0	1	0	0	1
13384	0	0	1	1	2
13386	0	1	1	0	2
13387	0	0	1	0	1
13388	0	0	1	0	1
13389	0	1	1	0	2
13391	0	0	0	1	1
13392	0	0	1	0	1
13393	0	1	0	0	1
13394	0	2	0	0	2
13397	0	1	0	0	1
13399	0	1	0	0	1
13400	0	0	2	0	2
13402	0	1	0	0	1
13403	0	0	1	0	1
13404	0	0	2	1	3
13405	0	3	0	0	3
13406	0	0	1	0	1
13407	0	0	1	0	1
13411	0	1	1	0	2
13412	0	1	0	0	1
13413	0	0	1	0	1
13415	0	0	2	0	2
13418	0	0	0	1	1
13419	0	0	1	0	1
13421	0	0	1	0	1
13423	0	1	0	0	1
13424	0	0	1	0	1
13426	0	1	1	0	2
13430	0	0	2	0	2
13432	0	0	1	0	1
13433	0	2	0	1	3
13434	0	1	0	1	2
13435	0	2	0	1	3
13436	0	1	1	0	2
13437	0	0	1	0	1
13438	0	1	4	0	5
13439	0	0	2	1	3
13440	0	2	1	0	3
13441	0	1	0	0	1
13442	0	1	0	0	1
13444	0	1	0	0	1
13445	0	1	0	1	2
13447	0	0	1	0	1
13449	0	1	1	0	2
13451	0	0	1	0	1
13452	0	1	0	1	2
13453	0	0	3	0	3
13454	0	0	0	1	1
13457	0	1	0	0	1
13458	0	1	0	0	1
13459	0	0	1	0	1
13460	0	0	0	1	1
13461	0	0	1	0	1
13462	0	1	3	1	5
13465	0	1	0	0	1
13466	0	0	1	0	1
13467	0	0	1	0	1
13468	0	0	0	1	1
13470	0	1	0	0	1
13471	0	0	0	1	1
13474	0	1	2	1	4
13475	0	1	0	0	1
13476	0	1	0	0	1
13477	0	2	1	0	3
13478	0	0	3	0	3
13480	0	0	1	0	1
13482	0	0	1	0	1
13483	0	0	1	0	1
13485	0	1	0	0	1
13487	0	1	0	0	1
13488	0	1	0	0	1
13489	0	0	0	1	1
13490	0	0	1	0	1
13491	0	1	0	0	1
13492	0	2	2	0	4
13493	0	1	1	0	2
13498	0	1	0	0	1
13499	0	0	1	0	1
13501	0	1	0	0	1
13502	0	0	1	0	1
13503	0	0	1	0	1
13504	0	0	0	1	1
13506	0	0	1	0	1
13509	0	1	0	0	1
13510	0	1	0	0	1
13511	0	0	2	1	3
13512	0	0	1	0	1
13514	0	0	1	0	1
13515	0	1	0	0	1
13516	0	0	1	0	1
13517	0	2	1	0	3
13518	0	1	1	0	2
13519	0	1	1	0	2
13520	0	0	3	0	3
13521	0	2	0	0	2
13522	0	0	1	0	1
13523	0	2	0	0	2
13525	0	0	2	0	2
13526	0	0	1	0	1
13529	0	1	0	0	1
13530	0	2	0	0	2
13531	0	1	2	0	3
13533	0	1	0	0	1
13534	0	0	1	0	1
13535	0	1	1	0	2
13537	0	0	1	0	1
13538	0	1	0	0	1
13539	0	1	0	0	1
13542	0	1	0	1	2
13543	0	1	0	0	1
13544	0	1	1	0	2
13545	0	1	1	0	2
13546	0	0	1	0	1
13547	0	0	0	2	2
13549	0	0	0	1	1
13550	0	0	1	0	1
13551	0	1	0	0	1
13553	0	1	0	0	1
13554	0	1	1	0	2
13556	0	0	0	1	1
13558	0	0	1	0	1
13559	0	0	2	1	3
13563	0	1	0	0	1
13565	0	1	1	0	2
13567	0	1	1	1	3
13568	0	1	1	1	3
13569	0	0	1	0	1
13570	0	2	0	0	2
13571	0	1	1	0	2
13572	0	2	1	0	3
13574	0	0	3	0	3
13575	0	0	0	1	1
13578	0	0	2	1	3
13579	0	1	1	0	2
13581	0	2	0	0	2
13583	0	0	2	1	3
13584	0	1	1	0	2
13586	0	0	0	1	1
13587	0	1	0	0	1
13589	0	0	1	0	1
13590	0	0	1	0	1
13591	0	1	1	0	2
13592	0	2	1	0	3
13593	0	0	0	1	1
13599	0	0	1	0	1
13602	0	1	1	0	2
13603	0	1	0	0	1
13604	0	0	0	1	1
13605	0	0	2	0	2
13606	0	2	1	0	3
13607	0	1	1	0	2
13608	0	0	0	1	1
13610	0	0	1	0	1
13617	0	0	0	1	1
13618	0	0	1	1	2
13620	0	0	1	0	1
13621	0	1	1	0	2
13622	0	0	1	1	2
13624	0	1	0	0	1
13625	0	0	1	0	1
13627	0	1	1	0	2
13628	0	0	2	0	2
13630	0	0	2	0	2
13632	0	0	2	0	2
13634	0	0	2	0	2
13635	0	0	1	0	1
13637	0	0	2	0	2
13638	0	0	1	0	1
13639	0	1	0	0	1
13640	0	2	0	1	3
13641	0	0	0	1	1
13642	0	0	1	0	1
13643	0	3	0	0	3
13644	0	0	1	1	2
13645	0	0	1	0	1
13646	0	0	0	1	1
13647	0	0	3	0	3
13649	0	0	2	0	2
13651	0	0	1	0	1
13652	0	1	2	0	3
13653	0	0	0	1	1
13654	0	1	0	0	1
13655	0	0	1	0	1
13659	0	0	0	1	1
13661	0	3	0	0	3
13663	0	0	1	0	1
13665	0	1	0	0	1
13666	0	1	1	0	2
13669	0	1	0	0	1
13670	0	1	0	1	2
13671	0	0	0	1	1
13672	0	0	1	0	1
13673	0	0	2	0	2
13674	0	1	0	0	1
13677	0	1	0	0	1
13678	0	0	1	0	1
13679	0	0	2	0	2
13680	0	2	0	0	2
13681	0	1	0	0	1
13682	0	1	0	0	1
13683	0	0	2	0	2
13685	0	1	0	0	1
13686	0	1	0	0	1
13689	0	0	1	0	1
13692	0	1	1	0	2
13693	0	0	0	1	1
13694	0	2	0	0	2
13697	0	0	0	1	1
13699	0	0	1	0	1
13702	0	0	2	0	2
13704	0	0	1	1	2
13706	0	1	1	0	2
13708	0	2	0	0	2
13709	0	0	1	0	1
13711	0	0	1	0	1
13712	0	1	0	1	2
13714	0	0	1	0	1
13715	0	1	0	0	1
13717	0	1	0	0	1
13718	0	0	1	0	1
13719	0	1	0	0	1
13721	0	1	0	0	1
13722	0	1	0	0	1
13724	0	2	1	0	3
13725	0	0	1	0	1
13727	0	2	0	0	2
13728	0	1	0	0	1
13731	0	0	1	0	1
13732	0	1	0	0	1
13734	0	0	1	0	1
13736	0	1	0	0	1
13737	0	1	0	0	1
13738	0	1	1	0	2
13739	0	1	2	0	3
13741	0	1	2	0	3
13742	0	1	0	0	1
13743	0	1	0	0	1
13744	0	0	0	1	1
13746	0	0	1	0	1
13748	0	1	1	0	2
13751	0	0	2	0	2
13752	0	0	1	0	1
13754	0	1	0	0	1
13757	0	1	1	0	2
13758	0	2	0	0	2
13759	0	0	0	1	1
13760	0	0	2	0	2
13761	0	1	0	0	1
13762	0	0	1	0	1
13763	0	1	1	0	2
13764	0	1	0	0	1
13765	0	0	1	0	1
13766	0	0	0	1	1
13767	0	0	1	0	1
13768	0	1	1	0	2
13771	0	0	0	1	1
13772	0	1	0	0	1
13773	0	1	0	0	1
13775	0	1	0	1	2
13778	0	0	2	0	2
13779	0	0	1	1	2
13780	0	1	0	0	1
13781	0	0	1	0	1
13782	0	1	0	0	1
13783	0	1	0	0	1
13785	0	1	0	0	1
13786	0	0	1	1	2
13787	0	2	0	0	2
13789	0	1	0	1	2
13791	0	1	1	1	3
13793	0	0	0	1	1
13795	0	0	2	0	2
13799	0	0	1	0	1
13800	0	1	0	0	1
13801	0	1	0	0	1
13803	0	0	2	1	3
13804	0	0	0	1	1
13806	0	1	0	0	1
13807	0	1	2	0	3
13808	0	1	0	0	1
13810	0	0	2	1	3
13811	0	1	0	0	1
13812	0	0	2	1	3
13816	0	0	0	1	1
13818	0	0	0	1	1
13819	0	0	0	1	1
13820	0	0	0	1	1
13821	0	1	0	2	3
13822	0	1	1	0	2
13823	0	0	1	1	2
13825	0	1	0	0	1
13826	0	0	1	0	1
13827	0	0	3	1	4
13828	0	2	1	0	3
13829	0	0	1	0	1
13831	0	0	2	0	2
13834	0	1	0	0	1
13835	0	0	1	0	1
13836	0	0	0	1	1
13837	0	1	0	0	1
13839	0	1	1	0	2
13841	0	1	0	0	1
13844	0	0	1	0	1
13846	0	1	1	0	2
13847	0	1	2	0	3
13849	0	0	1	0	1
13850	0	0	1	0	1
13853	0	1	1	0	2
13854	0	0	0	1	1
13855	0	1	1	0	2
13856	0	1	0	0	1
13857	0	0	1	0	1
13858	0	0	1	0	1
13862	0	1	0	0	1
13864	0	0	1	0	1
13865	0	0	1	0	1
13866	0	1	0	0	1
13867	0	0	3	0	3
13871	0	1	0	0	1
13873	0	1	1	0	2
13874	0	0	1	0	1
13875	0	1	0	0	1
13877	0	1	1	0	2
13878	0	0	1	0	1
13879	0	2	0	0	2
13881	0	1	0	0	1
13883	0	0	1	0	1
13885	0	0	0	1	1
13886	0	0	2	0	2
13887	0	1	0	0	1
13888	0	1	0	0	1
13891	0	0	0	1	1
13892	0	0	1	0	1
13894	0	0	1	0	1
13895	0	0	1	1	2
13898	0	0	1	0	1
13899	0	0	0	1	1
13900	0	0	1	0	1
13904	0	0	2	0	2
13905	0	0	1	0	1
13906	0	2	1	0	3
13907	0	0	1	0	1
13908	0	0	0	1	1
13909	0	1	0	0	1
13910	0	0	0	1	1
13912	0	1	0	0	1
13913	0	1	0	0	1
13914	0	1	1	0	2
13915	0	0	2	2	4
13916	0	0	1	1	2
13917	0	0	0	2	2
13918	0	0	0	1	1
13920	0	2	0	1	3
13921	0	0	1	0	1
13922	0	1	0	0	1
13923	0	1	2	0	3
13924	0	0	1	0	1
13925	0	1	0	0	1
13928	0	0	0	1	1
13929	0	1	2	0	3
13930	0	1	0	0	1
13931	0	0	1	1	2
13932	0	1	2	0	3
13937	0	2	1	0	3
13938	0	0	0	1	1
13939	0	0	1	0	1
13940	0	0	1	0	1
13943	0	2	0	0	2
13944	0	0	1	0	1
13947	0	0	2	0	2
13949	0	0	1	0	1
13950	0	0	1	0	1
13951	0	0	1	0	1
13952	0	0	1	0	1
13954	0	0	1	0	1
13956	0	0	1	1	2
13958	0	0	2	0	2
13959	0	2	0	0	2
13960	0	1	1	1	3
13963	0	0	1	0	1
13964	0	0	0	1	1
13965	0	2	0	1	3
13966	0	0	0	1	1
13968	0	1	2	0	3
13969	0	1	0	0	1
13970	0	0	2	0	2
13971	0	1	0	0	1
13972	0	1	0	0	1
13973	0	0	1	0	1
13975	0	1	0	0	1
13977	0	1	0	0	1
13979	0	0	1	1	2
13980	0	0	1	1	2
13981	0	0	1	0	1
13983	0	0	0	1	1
13984	0	0	1	1	2
13985	0	1	0	1	2
13992	0	1	0	0	1
13994	0	1	0	0	1
13995	0	0	0	1	1
13996	0	0	1	0	1
13997	0	0	1	0	1
13999	0	0	1	0	1
14000	0	0	1	0	1
14001	0	1	0	0	1
14004	0	0	1	1	2
14005	0	0	1	1	2
14006	0	1	1	0	2
14007	0	2	0	0	2
14011	0	1	1	1	3
14013	0	1	0	0	1
14016	0	0	0	1	1
14018	0	0	0	1	1
14019	0	1	1	0	2
14022	0	1	1	0	2
14026	0	1	0	0	1
14027	0	0	0	1	1
14028	0	1	1	0	2
14029	0	0	1	0	1
14030	0	1	0	0	1
14032	0	1	0	0	1
14033	0	0	1	0	1
14034	0	1	1	0	2
14035	0	1	0	1	2
14036	0	1	0	0	1
14039	0	0	0	1	1
14041	0	1	0	1	2
14042	0	0	2	0	2
14043	0	0	2	0	2
14044	0	0	1	0	1
14046	0	0	1	0	1
14047	0	1	1	0	2
14048	0	0	1	0	1
14049	0	1	0	0	1
14050	0	0	1	0	1
14051	0	0	0	1	1
14053	0	1	1	0	2
14054	0	1	0	0	1
14056	0	0	1	0	1
14057	0	2	1	0	3
14059	0	1	0	0	1
14061	0	1	0	0	1
14063	0	1	1	0	2
14067	0	0	2	0	2
14068	0	1	0	0	1
14069	0	1	0	0	1
14070	0	1	2	0	3
14072	0	2	1	0	3
14073	0	0	0	1	1
14074	0	0	1	0	1
14076	0	0	1	1	2
14077	0	1	0	0	1
14080	0	0	1	2	3
14081	0	0	2	1	3
14082	0	1	0	0	1
14083	0	0	1	0	1
14086	0	1	0	0	1
14088	0	1	0	0	1
14091	0	0	1	0	1
14092	0	1	0	0	1
14093	0	0	0	1	1
14094	0	1	0	0	1
14095	0	0	1	0	1
14096	0	1	1	0	2
14097	0	0	1	0	1
14098	0	1	1	0	2
14099	0	0	0	1	1
14102	0	1	0	0	1
14104	0	1	1	0	2
14105	0	1	0	0	1
14107	0	0	1	0	1
14109	0	0	0	1	1
14110	0	1	2	0	3
14112	0	0	2	0	2
14113	0	1	0	1	2
14116	0	1	0	0	1
14119	0	1	0	0	1
14120	0	0	1	1	2
14122	0	1	0	0	1
14123	0	1	1	0	2
14124	0	1	0	0	1
14125	0	0	1	0	1
14127	0	1	0	0	1
14128	0	1	0	0	1
14132	0	1	0	0	1
14133	0	1	1	0	2
14138	0	0	1	1	2
14143	0	1	1	0	2
14146	0	0	1	0	1
14147	0	2	0	0	2
14151	0	0	1	0	1
14156	0	0	0	1	1
14158	0	0	1	0	1
14159	0	2	1	0	3
14160	0	2	0	0	2
14162	0	0	2	0	2
14167	0	1	0	0	1
14168	0	1	0	0	1
14170	0	0	0	1	1
14172	0	1	0	0	1
14173	0	1	0	1	2
14174	0	0	1	0	1
14176	0	0	1	0	1
14179	0	0	1	0	1
14180	0	1	1	0	2
14181	0	1	2	0	3
14182	0	0	2	0	2
14183	0	1	0	1	2
14184	0	0	2	0	2
14187	0	1	0	0	1
14188	0	1	0	0	1
14189	0	1	0	0	1
14191	0	2	0	0	2
14193	0	0	0	1	1
14194	0	0	1	1	2
14195	0	0	2	1	3
14196	0	0	1	0	1
14198	0	1	0	0	1
14199	0	0	2	0	2
14200	0	1	0	0	1
14203	0	0	1	0	1
14204	0	1	1	1	3
14206	0	0	1	0	1
14208	0	1	0	0	1
14212	0	3	0	0	3
14215	0	1	2	0	3
14216	0	0	1	0	1
14217	0	0	2	0	2
14218	0	1	0	0	1
14220	0	1	0	1	2
14221	0	2	1	0	3
14222	0	0	0	1	1
14223	0	0	1	1	2
14226	0	0	1	0	1
14227	0	1	0	0	1
14231	0	1	1	0	2
14232	0	1	1	0	2
14233	0	1	0	0	1
14234	0	2	0	0	2
14235	0	0	1	0	1
14236	0	1	1	0	2
14240	0	0	1	0	1
14241	0	0	2	0	2
14243	0	0	1	0	1
14244	0	0	2	0	2
14245	0	0	0	1	1
14246	0	0	0	1	1
14248	0	0	1	0	1
14249	0	0	1	0	1
14250	0	2	2	0	4
14251	0	0	1	0	1
14253	0	0	1	0	1
14255	0	0	1	1	2
14256	0	0	1	0	1
14257	0	2	0	0	2
14258	0	1	2	0	3
14259	0	0	1	0	1
14260	0	0	1	0	1
14263	0	0	2	0	2
14264	0	1	0	0	1
14267	0	0	0	1	1
14268	0	0	0	1	1
14270	0	0	0	3	3
14272	0	0	1	0	1
14273	0	1	0	1	2
14274	0	1	0	0	1
14275	0	1	0	0	1
14280	0	0	1	0	1
14281	0	0	1	0	1
14282	0	0	1	0	1
14284	0	0	1	0	1
14285	0	0	0	1	1
14286	0	0	1	0	1
14287	0	2	2	0	4
14288	0	1	1	0	2
14289	0	0	1	0	1
14292	0	0	0	1	1
14294	0	1	1	0	2
14295	0	2	1	2	5
14298	0	0	1	0	1
14300	0	2	0	0	2
14301	0	1	0	0	1
14302	0	0	0	1	1
14303	0	1	0	0	1
14304	0	0	0	1	1
14306	0	0	1	0	1
14307	0	1	0	0	1
14309	0	0	1	0	1
14311	0	1	0	0	1
14312	0	0	1	0	1
14313	0	1	0	0	1
14314	0	0	1	0	1
14315	0	1	0	1	2
14316	0	0	2	0	2
14317	0	1	0	0	1
14319	0	0	2	0	2
14320	0	1	0	0	1
14321	0	0	2	0	2
14322	0	1	0	1	2
14323	0	1	0	1	2
14324	0	0	1	0	1
14325	0	1	0	0	1
14326	0	1	1	0	2
14332	0	0	1	0	1
14333	0	0	1	0	1
14334	0	2	0	0	2
14336	0	0	2	0	2
14337	0	0	1	0	1
14338	0	0	1	0	1
14339	0	0	0	1	1
14340	0	0	1	0	1
14341	0	0	0	1	1
14343	0	1	0	0	1
14346	0	0	2	0	2
14347	0	1	1	0	2
14348	0	0	1	0	1
14350	0	0	0	1	1
14352	0	1	0	0	1
14355	0	1	1	1	3
14356	0	1	0	0	1
14357	0	0	2	0	2
14364	0	1	1	0	2
14366	0	0	1	0	1
14368	0	1	0	0	1
14369	0	0	1	0	1
14374	0	0	0	1	1
14378	0	0	0	1	1
14379	0	0	1	1	2
14380	0	2	1	0	3
14381	0	1	0	0	1
14382	0	0	1	0	1
14383	0	1	0	0	1
14385	0	0	1	0	1
14386	0	1	0	0	1
14389	0	0	1	0	1
14390	0	1	1	0	2
14394	0	1	1	0	2
14397	0	0	1	0	1
14398	0	0	2	1	3
14400	0	1	0	0	1
14402	0	1	0	0	1
14403	0	0	0	1	1
14410	0	0	0	1	1
14421	0	2	0	0	2
14425	0	0	1	0	1
14426	0	1	0	0	1
14427	0	1	2	0	3
14429	0	0	1	0	1
14430	0	1	0	0	1
14433	0	1	1	0	2
14434	0	0	2	0	2
14435	0	1	2	1	4
14440	0	0	1	0	1
14442	0	1	0	0	1
14443	0	1	0	0	1
14448	0	0	1	0	1
14449	0	0	1	0	1
14451	0	1	0	0	1
14453	0	2	0	0	2
14458	0	1	0	0	1
14461	0	1	0	0	1
14462	0	1	0	0	1
14464	0	1	0	0	1
14466	0	1	1	0	2
14467	0	1	0	0	1
14470	0	1	0	0	1
14472	0	0	1	0	1
14473	0	0	1	0	1
14476	0	0	1	0	1
14477	0	1	0	0	1
14478	0	1	0	0	1
14479	0	0	2	0	2
14480	0	1	0	0	1
14482	0	1	0	0	1
14483	0	0	1	0	1
14484	0	1	0	0	1
14485	0	1	1	0	2
14486	0	0	1	0	1
14487	0	1	1	1	3
14491	0	0	1	0	1
14492	0	0	1	0	1
14495	0	1	0	0	1
14496	0	0	1	0	1
14497	0	0	1	0	1
14499	0	0	1	0	1
14501	0	1	0	0	1
14503	0	0	0	1	1
14504	0	0	0	1	1
14505	0	0	0	1	1
14507	0	0	1	0	1
14508	0	1	0	0	1
14509	0	1	2	0	3
14510	0	0	1	0	1
14511	0	1	0	0	1
14512	0	0	3	0	3
14513	0	1	0	0	1
14514	0	1	1	0	2
14518	0	1	0	0	1
14519	0	1	0	0	1
14521	0	1	0	0	1
14522	0	1	0	0	1
14525	0	1	0	0	1
14526	0	0	0	1	1
14527	0	0	0	1	1
14528	0	1	0	0	1
14533	0	0	1	0	1
14534	0	1	0	0	1
14535	0	0	0	1	1
14538	0	0	1	0	1
14540	0	1	0	0	1
14541	0	2	0	0	2
14542	0	0	1	0	1
14544	0	0	2	0	2
14545	0	1	0	0	1
14547	0	0	1	0	1
14550	0	0	0	1	1
14551	0	1	0	0	1
14553	0	1	2	0	3
14554	0	1	0	0	1
14556	0	0	1	0	1
14557	0	0	1	0	1
14558	0	1	2	0	3
14559	0	0	0	1	1
14561	0	1	0	0	1
14562	0	0	1	0	1
14563	0	1	1	0	2
14564	0	1	0	1	2
14569	0	0	1	0	1
14570	0	0	1	0	1
14571	0	1	0	0	1
14574	0	0	0	1	1
14575	0	1	0	1	2
14577	0	0	2	0	2
14578	0	0	0	1	1
14581	0	2	1	0	3
14582	0	0	0	1	1
14584	0	1	0	0	1
14585	0	0	2	0	2
14586	0	2	0	0	2
14588	0	0	1	0	1
14590	0	3	0	0	3
14591	0	0	1	0	1
14592	0	1	0	2	3
14593	0	1	0	0	1
14594	0	2	0	0	2
14600	0	0	1	0	1
14602	0	1	0	0	1
14603	0	0	1	0	1
14604	0	0	2	0	2
14605	0	1	2	1	4
14607	0	1	3	0	4
14609	0	1	0	0	1
14610	0	1	2	0	3
14612	0	1	0	0	1
14616	0	0	0	1	1
14617	0	1	0	0	1
14619	0	1	0	0	1
14621	0	0	1	0	1
14625	0	0	2	0	2
14626	0	0	0	1	1
14629	0	1	0	0	1
14630	0	2	0	0	2
14631	0	0	1	0	1
14632	0	1	0	0	1
14634	0	1	0	0	1
14635	0	0	1	0	1
14636	0	0	1	0	1
14639	0	1	2	0	3
14642	0	0	1	0	1
14645	0	0	1	0	1
14651	0	0	1	2	3
14656	0	0	1	0	1
14660	0	1	2	1	4
14662	0	1	0	0	1
14663	0	1	0	0	1
14664	0	0	1	0	1
14665	0	1	0	0	1
14666	0	1	0	0	1
14668	0	0	0	1	1
14672	0	1	3	0	4
14674	0	1	2	0	3
14675	0	0	1	0	1
14677	0	0	2	0	2
14678	0	0	2	0	2
14679	0	0	2	0	2
14683	0	0	2	1	3
14684	0	1	0	0	1
14685	0	0	1	0	1
14692	0	0	1	0	1
14694	0	0	2	0	2
14699	0	1	0	0	1
14700	0	1	0	0	1
14701	0	0	1	0	1
14703	0	1	0	0	1
14704	0	0	2	0	2
14705	0	0	2	0	2
14706	0	0	2	1	3
14711	0	0	1	0	1
14714	0	0	0	1	1
14715	0	1	0	0	1
14718	0	0	1	0	1
14719	0	1	1	0	2
14721	0	1	0	0	1
14723	0	0	0	1	1
14726	0	0	1	0	1
14728	0	2	0	0	2
14729	0	0	1	0	1
14731	0	0	1	0	1
14732	0	0	1	0	1
14733	0	1	0	0	1
14736	0	0	1	0	1
14737	0	1	0	1	2
14742	0	0	1	0	1
14744	0	0	2	0	2
14751	0	0	1	0	1
14753	0	2	0	0	2
14757	0	1	0	0	1
14760	0	0	1	0	1
14761	0	1	0	0	1
14765	0	0	2	0	2
14769	0	1	0	0	1
14772	0	1	1	0	2
14774	0	0	1	0	1
14776	0	0	1	0	1
14777	0	1	0	0	1
14778	0	1	0	0	1
14779	0	2	1	0	3
14781	0	0	1	0	1
14786	0	0	1	0	1
14787	0	1	0	0	1
14788	0	0	1	0	1
14789	0	1	0	0	1
14790	0	0	1	0	1
14791	0	2	0	1	3
14792	0	1	0	1	2
14798	0	0	2	0	2
14801	0	0	1	0	1
14802	0	0	1	0	1
14803	0	1	1	0	2
14804	0	1	1	0	2
14807	0	0	2	0	2
14809	0	0	1	0	1
14811	0	0	1	0	1
14812	0	1	0	0	1
14815	0	0	1	0	1
14816	0	0	1	0	1
14817	0	1	1	0	2
14818	0	1	0	0	1
14819	0	1	0	0	1
14821	0	0	1	0	1
14822	0	0	1	0	1
14826	0	1	0	0	1
14827	0	0	1	0	1
14828	0	1	0	0	1
14830	0	0	1	0	1
14831	0	0	2	0	2
14836	0	0	1	0	1
14841	0	0	1	0	1
14843	0	1	1	0	2
14845	0	0	1	0	1
14846	0	1	1	0	2
14847	0	0	1	0	1
14854	0	1	0	0	1
14855	0	0	2	0	2
14860	0	0	1	0	1
14864	0	1	0	0	1
14868	0	1	1	2	4
14870	0	1	0	0	1
14871	0	1	0	0	1
14873	0	1	0	0	1
14875	0	2	0	0	2
14876	0	0	1	1	2
14877	0	1	0	0	1
14878	0	0	0	1	1
14880	0	0	1	0	1
14881	0	0	1	0	1
14883	0	2	0	0	2
14884	0	1	1	0	2
14886	0	0	1	0	1
14889	0	0	1	0	1
14891	0	1	0	0	1
14892	0	1	0	0	1
14898	0	0	1	0	1
14901	0	0	1	0	1
14902	0	1	0	1	2
14905	0	0	1	0	1
14906	0	1	0	0	1
14908	0	1	0	0	1
14909	0	0	1	1	2
14910	0	0	1	0	1
14911	0	0	1	0	1
14914	0	0	1	0	1
14915	0	0	0	1	1
14916	0	0	1	0	1
14919	0	0	1	0	1
14921	0	1	1	0	2
14922	0	1	1	0	2
14925	0	0	1	0	1
14926	0	1	1	0	2
14928	0	1	0	1	2
14929	0	1	0	0	1
14931	0	1	0	1	2
14936	0	3	0	1	4
14937	0	1	0	0	1
14938	0	0	1	0	1
14939	0	0	2	0	2
14940	0	0	2	0	2
14941	0	1	0	0	1
14942	0	0	1	0	1
14944	0	0	1	1	2
14945	0	0	1	0	1
14948	0	1	0	0	1
14949	0	1	0	0	1
14950	0	1	0	0	1
14955	0	1	0	0	1
14957	0	0	1	0	1
14958	0	0	1	0	1
14966	0	1	0	0	1
14968	0	1	0	0	1
14971	0	0	1	1	2
14973	0	1	0	0	1
14976	0	0	0	1	1
14979	0	0	1	0	1
14982	0	1	0	0	1
14984	0	0	1	0	1
14987	0	1	0	0	1
14988	0	0	0	1	1
14990	0	1	0	0	1
14992	0	1	0	0	1
14994	0	0	2	0	2
14996	0	1	0	0	1
14997	0	0	0	1	1
15001	0	0	1	0	1
15002	0	0	1	0	1
15003	0	1	1	0	2
15005	0	1	0	0	1
15008	0	0	1	0	1
15010	0	1	0	0	1
15011	0	0	1	0	1
15012	0	0	1	0	1
15014	0	1	0	0	1
15015	0	0	0	1	1
15016	0	0	1	0	1
15019	0	0	1	0	1
15022	0	0	3	0	3
15024	0	1	0	0	1
15027	0	0	1	0	1
15028	0	1	0	0	1
15030	0	0	1	0	1
15038	0	1	0	1	2
15039	0	0	1	0	1
15040	0	1	0	0	1
15042	0	0	1	0	1
15050	0	0	2	0	2
15051	0	0	1	0	1
15052	0	0	1	0	1
15060	0	0	1	0	1
15061	0	2	1	0	3
15063	0	2	0	0	2
15064	0	0	1	0	1
15065	0	0	1	0	1
15067	0	1	0	0	1
15068	0	1	1	0	2
15069	0	1	0	0	1
15070	0	1	0	1	2
15073	0	0	1	0	1
15075	0	1	0	0	1
15077	0	1	0	0	1
15079	0	1	0	0	1
15081	0	1	2	0	3
15085	0	2	0	0	2
15089	0	0	2	0	2
15090	0	0	1	0	1
15091	0	0	1	0	1
15093	0	1	0	0	1
15095	0	0	0	1	1
15096	0	2	0	0	2
15101	0	0	1	1	2
15104	0	0	1	0	1
15108	0	1	0	0	1
15110	0	1	0	0	1
15113	0	0	0	1	1
15115	0	0	1	0	1
15117	0	1	0	0	1
15118	0	1	0	0	1
15119	0	0	1	0	1
15120	0	0	1	0	1
15122	0	0	1	0	1
15129	0	1	0	0	1
15130	0	1	0	0	1
15131	0	2	0	1	3
15135	0	1	1	0	2
15136	0	1	0	0	1
15138	0	0	1	0	1
15139	0	0	2	0	2
15141	0	0	1	0	1
15142	0	0	1	0	1
15145	0	1	0	0	1
15149	0	0	1	0	1
15151	0	0	1	0	1
15158	0	0	1	0	1
15163	0	0	1	0	1
15166	0	0	0	2	2
15169	0	1	0	0	1
15175	0	0	0	1	1
15177	0	0	1	0	1
15181	0	0	1	0	1
15184	0	1	1	0	2
15185	0	0	1	1	2
15186	0	0	1	1	2
15187	0	1	1	0	2
15188	0	0	1	0	1
15194	0	0	1	0	1
15198	0	1	0	0	1
15201	0	0	1	0	1
15202	0	1	0	0	1
15205	0	1	0	0	1
15208	0	1	0	0	1
15211	0	0	1	0	1
15216	0	1	1	0	2
15218	0	0	1	0	1
15219	0	0	2	0	2
15220	0	0	1	0	1
15221	0	0	0	1	1
15223	0	0	1	0	1
15226	0	1	0	1	2
15227	0	1	0	0	1
15230	0	0	0	1	1
15232	0	0	1	0	1
15234	0	0	1	0	1
15235	0	1	0	0	1
15237	0	1	0	0	1
15238	0	0	1	0	1
15239	0	1	0	0	1
15243	0	0	0	1	1
15244	0	1	1	0	2
15249	0	1	1	0	2
15250	0	1	0	0	1
15254	0	0	1	0	1
15256	0	1	0	1	2
15262	0	1	0	0	1
15263	0	0	1	0	1
15267	0	0	0	1	1
15270	0	0	2	0	2
15271	0	0	1	0	1
15272	0	1	0	0	1
15273	0	1	1	0	2
15274	0	0	1	0	1
15275	0	1	1	0	2
15276	0	1	0	0	1
15279	0	0	0	1	1
15281	0	1	1	0	2
15283	0	0	0	1	1
15284	0	0	1	0	1
15286	0	1	1	0	2
15289	0	0	1	1	2
15291	0	2	0	0	2
15292	0	0	1	0	1
15294	0	1	0	0	1
15295	0	1	1	0	2
15297	0	0	1	0	1
15298	0	1	0	0	1
15300	0	0	0	1	1
15305	0	0	1	0	1
15310	0	1	1	1	3
15311	0	1	0	0	1
15312	0	0	1	0	1
15314	0	0	2	0	2
15315	0	1	1	1	3
15316	0	0	1	0	1
15320	0	1	1	0	2
15322	0	0	1	0	1
15323	0	0	1	0	1
15325	0	0	1	1	2
15326	0	0	1	0	1
15330	0	1	0	0	1
15331	0	1	0	0	1
15332	0	0	1	0	1
15333	0	0	0	1	1
15336	0	0	2	0	2
15337	0	1	0	1	2
15338	0	0	1	0	1
15340	0	0	0	1	1
15343	0	1	0	0	1
15347	0	1	0	0	1
15349	0	0	1	0	1
15350	0	0	1	0	1
15352	0	1	0	0	1
15353	0	0	1	0	1
15358	0	0	0	1	1
15359	0	1	1	0	2
15360	0	1	0	0	1
15361	0	0	1	0	1
15363	0	1	1	0	2
15370	0	0	1	0	1
15371	0	0	0	1	1
15372	0	1	1	0	2
15373	0	1	0	0	1
15375	0	1	0	0	1
15376	0	1	0	0	1
15379	0	1	0	0	1
15384	0	0	1	0	1
15386	0	0	1	0	1
15387	0	0	1	0	1
15394	0	1	1	0	2
15397	0	1	1	0	2
15400	0	0	1	0	1
15401	0	1	1	0	2
15405	0	1	0	0	1
15409	0	0	3	0	3
15412	0	0	0	1	1
15414	0	0	1	0	1
15415	0	1	0	0	1
15420	0	0	1	0	1
15421	0	1	0	0	1
15422	0	0	1	0	1
15423	0	0	2	0	2
15426	0	0	1	0	1
15428	0	0	1	0	1
15429	0	0	1	0	1
15431	0	1	1	0	2
15433	0	0	1	0	1
15438	0	0	1	0	1
15440	0	0	1	1	2
15444	0	1	0	0	1
15446	0	0	2	0	2
15452	0	0	1	0	1
15455	0	1	0	0	1
15456	0	0	0	1	1
15458	0	2	0	0	2
15460	0	1	2	0	3
15461	0	1	0	0	1
15462	0	1	0	0	1
15470	0	1	0	0	1
15471	0	0	2	0	2
15472	0	0	1	0	1
15475	0	0	0	1	1
15476	0	1	0	0	1
15478	0	1	0	0	1
15482	0	1	1	0	2
15484	0	1	0	0	1
15485	0	2	0	0	2
15488	0	2	0	0	2
15489	0	1	0	0	1
15490	0	0	1	0	1
15492	0	0	1	0	1
15498	0	0	1	0	1
15499	0	0	0	2	2
15500	0	0	1	0	1
15501	0	1	0	0	1
15504	0	1	0	0	1
15506	0	0	1	0	1
15509	0	1	0	0	1
15515	0	0	1	0	1
15516	0	0	1	0	1
15517	0	0	0	1	1
15523	0	0	1	0	1
15525	0	0	0	1	1
15528	0	1	0	0	1
15529	0	0	1	0	1
15530	0	0	1	0	1
15533	0	0	1	0	1
15535	0	0	1	1	2
15538	0	1	0	0	1
15540	0	0	1	0	1
15541	0	0	1	0	1
15544	0	1	0	0	1
15545	0	0	2	1	3
15546	0	0	1	0	1
15547	0	0	1	0	1
15548	0	1	0	0	1
15549	0	1	0	0	1
15550	0	1	0	0	1
15551	0	1	0	0	1
15552	0	0	2	0	2
15553	0	1	1	0	2
15555	0	0	1	0	1
15556	0	0	0	1	1
15558	0	0	1	0	1
15561	0	1	0	0	1
15562	0	0	1	0	1
15563	0	1	0	0	1
15564	0	0	1	0	1
15565	0	1	1	0	2
15566	0	1	0	0	1
15568	0	0	0	2	2
15573	0	0	1	0	1
15578	0	1	0	0	1
15579	0	1	0	0	1
15583	0	1	0	0	1
15584	0	0	0	1	1
15586	0	1	0	0	1
15588	0	0	4	0	4
15589	0	0	1	0	1
15591	0	2	0	0	2
15592	0	1	0	0	1
15594	0	1	0	1	2
15595	0	0	1	0	1
15596	0	1	0	0	1
15598	0	0	1	0	1
15602	0	0	0	1	1
15603	0	1	0	0	1
15611	0	1	0	0	1
15614	0	0	0	1	1
15615	0	0	1	0	1
15617	0	0	1	1	2
15619	0	1	0	1	2
15620	0	2	0	0	2
15621	0	0	1	0	1
15622	0	0	1	0	1
15623	0	1	0	0	1
15624	0	0	1	0	1
15625	0	1	0	0	1
15629	0	1	0	0	1
15634	0	0	1	0	1
15635	0	0	1	1	2
15637	0	1	1	0	2
15638	0	0	1	0	1
15640	0	1	0	0	1
15641	0	0	1	0	1
15642	0	1	0	0	1
15644	0	0	0	1	1
15646	0	0	1	0	1
15647	0	0	1	0	1
15648	0	2	0	0	2
15650	0	1	1	0	2
15651	0	0	0	1	1
15656	0	0	1	0	1
15658	0	1	0	0	1
15660	0	0	1	0	1
15662	0	0	0	1	1
15667	0	1	0	0	1
15670	0	0	1	0	1
15671	0	1	0	0	1
15673	0	0	1	0	1
15674	0	1	0	1	2
15677	0	0	0	2	2
15678	0	1	0	0	1
15679	0	0	1	0	1
15681	0	0	0	1	1
15685	0	1	0	0	1
15686	0	0	1	0	1
15688	0	1	1	0	2
15689	0	0	1	0	1
15701	0	0	1	0	1
15705	0	0	1	0	1
15710	0	0	1	0	1
15713	0	0	1	0	1
15716	0	0	1	0	1
15718	0	0	1	0	1
15721	0	0	1	0	1
15722	0	1	0	0	1
15723	0	0	0	1	1
15724	0	0	1	0	1
15729	0	0	1	0	1
15730	0	0	0	1	1
15733	0	0	1	0	1
15734	0	0	1	0	1
15737	0	1	0	0	1
15738	0	0	0	1	1
15740	0	1	1	0	2
15743	0	0	0	2	2
15744	0	0	1	0	1
15746	0	2	0	0	2
15749	0	0	0	1	1
15751	0	1	0	0	1
15754	0	1	0	0	1
15759	0	0	1	0	1
15760	0	0	1	0	1
15763	0	1	0	1	2
15766	0	1	1	0	2
15769	0	1	0	0	1
15771	0	0	1	0	1
15772	0	1	1	0	2
15777	0	0	1	0	1
15778	0	1	1	0	2
15780	0	1	0	0	1
15781	0	1	0	1	2
15782	0	0	0	1	1
15784	0	0	1	0	1
15791	0	0	1	0	1
15796	0	1	0	0	1
15800	0	1	0	0	1
15806	0	1	0	0	1
15809	0	0	1	0	1
15810	0	0	0	1	1
15813	0	1	0	0	1
15815	0	0	1	0	1
15817	0	0	0	1	1
15819	0	0	1	0	1
15820	0	1	0	0	1
15821	0	0	1	0	1
15822	0	0	1	0	1
15823	0	1	0	0	1
15827	0	0	1	0	1
15828	0	0	1	0	1
15831	0	0	1	0	1
15833	0	0	0	1	1
15837	0	1	0	0	1
15838	0	0	1	0	1
15842	0	1	1	0	2
15846	0	1	1	0	2
15853	0	0	2	0	2
15854	0	1	0	1	2
15858	0	2	0	0	2
15862	0	0	2	0	2
15864	0	0	1	0	1
15869	0	0	1	0	1
15874	0	1	0	0	1
15875	0	0	0	1	1
15876	0	1	0	0	1
15878	0	0	1	0	1
15881	0	0	1	0	1
15885	0	0	1	0	1
15891	0	1	0	0	1
15895	0	1	0	1	2
15897	0	1	0	0	1
15901	0	0	1	0	1
15902	0	1	0	0	1
15903	0	0	0	1	1
15906	0	1	1	0	2
15910	0	0	1	0	1
15916	0	1	0	0	1
15918	0	1	0	0	1
15923	0	1	1	0	2
15926	0	0	1	0	1
15929	0	0	1	0	1
15930	0	0	0	1	1
15932	0	1	1	0	2
15935	0	1	0	0	1
15936	0	1	0	0	1
15939	0	1	1	1	3
15940	0	0	1	0	1
15941	0	1	0	0	1
15944	0	1	0	0	1
15946	0	0	1	0	1
15949	0	1	0	0	1
15957	0	0	1	0	1
15961	0	1	1	0	2
15962	0	0	0	1	1
15966	0	1	0	0	1
15972	0	0	0	1	1
15973	0	1	0	0	1
15977	0	0	1	0	1
15978	0	0	1	0	1
15979	0	1	2	0	3
15981	0	1	0	0	1
15986	0	0	1	0	1
15990	0	0	0	1	1
15995	0	0	1	0	1
15996	0	1	0	0	1
15998	0	1	0	0	1
16002	0	1	0	0	1
16003	0	0	1	1	2
16006	0	0	1	0	1
16009	0	0	1	0	1
16010	0	1	0	0	1
16011	0	0	0	1	1
16014	0	1	1	0	2
16015	0	0	1	0	1
16018	0	0	1	0	1
16021	0	0	1	0	1
16026	0	1	0	0	1
16028	0	0	1	0	1
16032	0	0	1	0	1
16033	0	1	1	0	2
16035	0	1	0	0	1
16038	0	0	1	0	1
16041	1	0	0	0	1
16043	0	1	0	0	1
16049	0	0	1	0	1
16050	0	1	0	0	1
16051	0	0	1	0	1
16056	0	0	1	0	1
16059	0	0	1	0	1
16060	0	0	1	0	1
16062	0	1	0	0	1
16064	0	0	1	0	1
16068	0	1	0	1	2
16069	0	1	0	0	1
16072	0	0	0	1	1
16074	0	0	2	1	3
16078	0	0	1	0	1
16083	0	1	0	0	1
16087	0	1	0	0	1
16089	0	0	1	0	1
16090	0	0	0	1	1
16095	0	1	0	0	1
16103	0	0	0	1	1
16105	0	0	1	0	1
16108	0	0	1	0	1
16115	0	0	2	0	2
16128	0	1	0	0	1
16129	0	0	1	0	1
16132	0	0	1	1	2
16136	0	0	1	0	1
16141	0	1	0	0	1
16143	0	1	1	0	2
16144	0	1	0	0	1
16154	0	0	1	0	1
16156	0	1	0	0	1
16159	0	1	0	0	1
16163	0	1	0	0	1
16173	0	1	0	0	1
16174	0	1	0	0	1
16177	0	1	0	0	1
16180	0	0	1	0	1
16181	0	1	0	0	1
16184	0	0	2	0	2
16185	0	0	2	1	3
16191	0	1	0	0	1
16193	0	0	1	1	2
16197	0	0	1	0	1
16201	0	0	1	0	1
16204	0	1	0	0	1
16205	0	0	1	0	1
16209	0	0	0	1	1
16212	0	0	0	1	1
16214	0	0	1	0	1
16220	0	0	1	0	1
16221	0	0	1	0	1
16222	0	0	0	1	1
16230	0	0	1	0	1
16236	0	0	1	0	1
16237	0	1	0	0	1
16240	0	0	1	0	1
16242	0	1	1	0	2
16243	0	0	1	0	1
16247	0	0	1	0	1
16250	0	0	1	0	1
16252	0	1	0	0	1
16260	0	1	0	0	1
16263	0	1	0	0	1
16265	0	0	1	0	1
16267	0	1	0	0	1
16273	0	1	0	0	1
16274	0	1	0	0	1
16277	0	1	2	0	3
16279	0	1	0	0	1
16281	0	1	1	0	2
16287	0	0	1	0	1
16290	0	0	1	0	1
16293	0	0	1	0	1
16295	0	0	1	1	2
16299	0	1	0	0	1
16301	0	0	0	1	1
16302	0	0	1	0	1
16306	0	0	1	0	1
16307	0	0	0	1	1
16314	0	1	0	0	1
16320	0	0	0	1	1
16321	0	0	1	1	2
16328	0	1	0	0	1
16330	0	1	0	0	1
16333	0	1	1	0	2
16334	0	0	0	1	1
16339	0	0	1	0	1
16342	0	1	0	0	1
16343	0	1	0	0	1
16346	0	0	1	0	1
16353	0	1	0	0	1
16354	0	0	2	0	2
16357	0	1	0	1	2
16370	0	0	1	0	1
16373	0	0	0	1	1
16377	0	0	1	0	1
16378	0	0	0	1	1
16381	0	0	1	0	1
16382	0	1	0	0	1
16383	0	0	0	1	1
16385	0	1	0	1	2
16405	0	1	0	0	1
16411	0	1	0	0	1
16414	0	0	1	0	1
16421	0	1	0	0	1
16430	0	1	0	1	2
16431	0	0	1	0	1
16434	0	0	0	1	1
16437	0	0	1	0	1
16438	0	0	1	0	1
16439	0	1	0	0	1
16444	0	0	1	0	1
16452	0	1	0	1	2
16459	0	0	0	1	1
16460	0	0	1	0	1
16465	0	1	0	0	1
16467	0	0	1	0	1
16475	0	0	1	0	1
16478	0	1	0	0	1
16479	0	0	1	0	1
16480	0	0	1	0	1
16481	0	1	1	1	3
16483	0	0	0	1	1
16485	0	2	1	0	3
16486	0	0	0	1	1
16487	0	1	1	0	2
16488	0	0	1	0	1
16494	0	1	0	0	1
16495	0	0	1	0	1
16496	0	0	0	1	1
16500	0	0	1	0	1
16507	0	1	0	0	1
16509	0	0	0	1	1
16512	0	1	1	0	2
16513	0	1	0	0	1
16514	0	0	1	0	1
16515	0	1	0	0	1
16519	0	0	1	0	1
16520	0	0	1	0	1
16523	0	1	0	0	1
16524	0	0	1	0	1
16525	0	0	1	0	1
16526	0	1	0	0	1
16530	0	0	1	0	1
16533	0	0	1	0	1
16537	0	0	1	0	1
16541	0	0	1	0	1
16547	0	1	0	0	1
16551	0	1	0	0	1
16553	0	1	1	0	2
16555	0	1	0	0	1
16556	0	0	1	0	1
16557	0	1	0	0	1
16559	0	0	1	0	1
16560	0	0	1	0	1
16561	0	1	0	0	1
16563	0	0	1	0	1
16566	0	0	1	0	1
16572	0	1	1	0	2
16574	0	1	0	0	1
16576	0	0	1	0	1
16582	0	0	1	0	1
16583	0	0	1	0	1
16586	0	0	1	0	1
16595	0	1	0	0	1
16601	0	0	2	0	2
16608	0	0	1	0	1
16609	0	1	1	0	2
16610	0	0	2	0	2
16613	0	0	0	1	1
16618	0	0	1	0	1
16620	0	0	1	0	1
16622	0	0	1	1	2
16624	0	0	1	0	1
16625	0	0	1	0	1
16626	0	1	0	0	1
16627	0	1	0	0	1
16629	0	0	1	0	1
16630	0	1	0	0	1
16633	0	1	1	0	2
16635	0	0	1	0	1
16639	0	0	1	0	1
16641	0	0	1	0	1
16643	0	0	1	0	1
16649	0	1	1	0	2
16650	0	1	0	0	1
16652	0	1	0	0	1
16654	0	0	1	0	1
16667	0	0	0	1	1
16669	0	1	0	0	1
16670	0	0	0	1	1
16676	0	0	1	0	1
16680	0	0	1	0	1
16695	0	0	0	1	1
16706	0	0	1	0	1
16708	0	2	0	0	2
16709	0	1	0	0	1
16717	0	0	1	0	1
16718	0	1	0	0	1
16720	0	1	0	0	1
16726	0	1	0	0	1
16727	0	0	1	0	1
16734	0	0	1	0	1
16735	0	1	0	0	1
16738	0	1	0	0	1
16739	0	1	0	0	1
16743	0	1	2	0	3
16745	0	0	1	0	1
16747	0	0	1	0	1
16752	0	0	1	0	1
16753	0	0	1	1	2
16754	0	1	0	0	1
16755	0	0	1	0	1
16760	0	0	1	0	1
16762	0	0	1	0	1
16763	0	0	1	0	1
16767	0	0	1	0	1
16770	0	0	0	1	1
16773	0	1	0	0	1
16774	0	0	1	0	1
16776	0	0	1	0	1
16777	0	1	0	0	1
16778	0	2	0	0	2
16790	0	0	0	1	1
16795	0	0	1	0	1
16796	0	0	1	0	1
16797	0	0	1	0	1
16801	0	1	0	0	1
16804	0	0	1	0	1
16806	0	1	1	0	2
16810	0	0	1	0	1
16820	0	2	0	0	2
16822	0	1	0	0	1
16826	0	0	1	0	1
16827	0	1	0	0	1
16828	0	1	1	0	2
16836	0	0	1	0	1
16844	0	0	0	1	1
16853	0	0	1	1	2
16862	0	1	0	0	1
16863	0	0	1	0	1
16867	0	0	2	0	2
16873	0	0	1	0	1
16875	0	0	1	0	1
16876	0	0	1	0	1
16878	0	0	0	1	1
16879	0	0	1	0	1
16880	0	1	0	0	1
16884	0	0	1	0	1
16887	0	1	0	0	1
16890	0	0	1	0	1
16901	0	1	2	0	3
16904	0	0	1	0	1
16911	0	1	0	0	1
16912	0	1	0	0	1
16923	0	1	0	1	2
16925	0	0	1	0	1
16926	0	1	0	0	1
16927	0	0	0	1	1
16928	0	0	0	1	1
16929	0	0	1	0	1
16930	0	1	0	0	1
16933	0	0	0	1	1
16943	0	1	0	0	1
16944	0	0	0	1	1
16948	0	0	0	1	1
16950	0	0	0	1	1
16956	0	0	1	0	1
16959	0	0	1	0	1
16967	0	0	1	0	1
16969	0	0	1	0	1
16972	0	0	0	2	2
16973	0	0	1	0	1
16974	0	1	0	0	1
16977	0	0	1	1	2
16979	0	0	1	0	1
16982	0	0	1	0	1
16989	0	1	1	0	2
16994	0	0	1	0	1
17001	0	0	0	1	1
17012	0	1	1	0	2
17016	0	0	1	0	1
17019	0	0	1	0	1
17023	0	0	1	0	1
17024	0	1	0	0	1
17030	0	0	0	1	1
17032	0	1	0	0	1
17038	0	0	1	0	1
17043	0	0	1	0	1
17044	0	1	1	0	2
17046	0	1	0	0	1
17053	0	2	0	0	2
17058	0	0	1	0	1
17063	0	1	0	0	1
17064	0	0	1	0	1
17066	0	0	0	1	1
17070	0	0	1	0	1
17071	0	0	1	0	1
17072	0	0	1	0	1
17073	0	0	1	0	1
17075	0	0	1	0	1
17076	0	0	1	0	1
17082	0	1	0	0	1
17083	0	1	0	0	1
17089	0	1	0	0	1
17090	0	1	0	0	1
17093	0	1	0	0	1
17106	0	0	0	1	1
17111	0	0	1	0	1
17113	0	0	1	0	1
17116	0	0	0	1	1
17118	0	0	1	0	1
17121	0	1	0	0	1
17122	0	0	0	1	1
17123	0	0	0	1	1
17128	0	0	0	1	1
17131	0	1	0	1	2
17140	0	0	1	0	1
17141	0	0	1	0	1
17147	0	0	1	0	1
17148	0	1	0	0	1
17150	0	0	1	0	1
17155	0	0	1	0	1
17156	0	0	1	0	1
17157	0	0	1	0	1
17158	0	2	0	0	2
17166	0	0	1	0	1
17168	0	0	1	0	1
17177	0	0	2	0	2
17183	0	0	0	1	1
17186	0	1	0	0	1
17188	0	1	0	0	1
17189	0	1	0	0	1
17194	0	1	0	0	1
17200	0	0	1	0	1
17201	0	0	1	0	1
17204	0	1	1	0	2
17228	0	1	0	0	1
17229	0	1	0	0	1
17231	0	1	0	0	1
17232	0	0	1	0	1
17233	0	1	0	0	1
17234	0	1	0	0	1
17238	0	0	0	1	1
17239	0	1	0	0	1
17240	0	0	0	1	1
17246	0	0	2	0	2
17247	0	0	1	0	1
17251	0	0	0	1	1
17252	0	1	1	0	2
17255	0	2	0	0	2
17259	0	0	0	1	1
17260	0	0	1	0	1
17274	0	0	1	0	1
17281	0	0	0	1	1
17285	0	0	1	0	1
17286	0	1	1	0	2
17288	0	0	1	0	1
17297	0	1	0	0	1
17309	0	1	0	0	1
17315	0	2	1	2	5
17317	0	0	1	0	1
17329	0	1	0	0	1
17333	0	0	1	0	1
17339	0	0	0	1	1
17344	0	1	0	0	1
17362	0	0	1	0	1
17372	0	0	1	0	1
17373	0	0	2	0	2
17376	0	0	1	0	1
17379	0	0	1	0	1
17382	0	1	0	0	1
17385	0	0	1	0	1
17390	0	3	1	0	4
17392	0	1	0	0	1
17395	0	1	1	0	2
17403	0	0	0	1	1
17407	0	1	0	0	1
17411	0	1	0	0	1
17413	0	0	1	0	1
17419	0	1	0	0	1
17427	0	0	1	0	1
17430	0	0	1	0	1
17433	0	0	1	0	1
17435	0	1	0	0	1
17438	0	0	1	0	1
17442	0	1	0	0	1
17443	0	1	0	0	1
17446	0	1	0	0	1
17452	0	1	1	0	2
17456	0	0	1	0	1
17457	0	2	0	1	3
17459	0	0	1	0	1
17468	0	0	1	1	2
17477	0	0	0	1	1
17478	0	0	0	1	1
17482	0	1	0	0	1
17484	0	0	0	1	1
17489	0	1	0	0	1
17498	0	3	0	0	3
17504	0	0	0	1	1
17505	0	1	0	0	1
17509	0	1	0	0	1
17515	0	1	0	0	1
17518	0	0	1	0	1
17523	0	1	1	0	2
17529	0	1	0	0	1
17538	0	0	0	1	1
17542	0	1	0	0	1
17550	0	0	1	0	1
17551	0	1	0	0	1
17556	0	1	0	0	1
17557	0	0	0	2	2
17559	0	0	1	0	1
17567	0	0	0	1	1
17571	0	1	0	0	1
17576	0	0	1	0	1
17577	0	0	0	1	1
17581	0	0	1	0	1
17584	0	0	2	0	2
17586	0	1	0	0	1
17589	0	0	1	0	1
17590	0	1	0	0	1
17592	0	0	1	0	1
17593	0	0	1	1	2
17597	0	1	0	0	1
17617	0	1	0	0	1
17621	0	0	1	0	1
17633	0	0	1	0	1
17636	0	0	1	0	1
17638	0	0	1	0	1
17642	0	0	1	0	1
17648	0	1	0	0	1
17651	0	0	1	0	1
17654	0	0	1	0	1
17658	0	0	2	1	3
17661	0	0	1	0	1
17663	0	0	1	0	1
17664	0	0	1	0	1
17665	0	1	0	0	1
17669	0	1	0	0	1
17672	0	0	0	1	1
17674	0	0	1	0	1
17680	0	1	0	0	1
17682	0	0	1	0	1
17684	0	0	1	0	1
17688	0	0	1	0	1
17691	0	2	1	0	3
17692	0	0	1	0	1
17698	0	1	0	0	1
17699	0	0	0	1	1
17704	0	0	1	0	1
17707	0	0	1	0	1
17708	0	0	1	0	1
17712	0	1	0	0	1
17717	0	1	0	0	1
17727	0	0	1	0	1
17728	0	0	1	0	1
17730	0	0	1	0	1
17736	0	0	1	0	1
17740	0	0	0	1	1
17743	0	0	1	0	1
17751	0	0	1	0	1
17756	0	1	0	0	1
17766	0	0	1	0	1
17771	0	0	1	0	1
17776	0	1	0	0	1
17780	0	0	1	0	1
17793	0	1	0	0	1
17802	0	1	0	0	1
17812	0	0	1	0	1
17814	0	0	1	0	1
17815	0	0	0	1	1
17829	0	1	0	0	1
17830	0	0	1	0	1
17831	0	0	1	0	1
17832	0	1	0	0	1
17834	0	0	0	1	1
17838	0	0	1	0	1
17840	0	1	0	0	1
17842	0	0	1	0	1
17844	0	0	1	0	1
17855	0	0	1	0	1
17858	0	0	1	0	1
17861	0	0	1	0	1
17867	0	0	1	0	1
17868	0	1	0	0	1
17875	0	0	1	0	1
17876	0	0	1	0	1
17877	0	0	1	0	1
17880	0	0	0	1	1
17886	0	0	1	0	1
17887	0	0	1	0	1
17893	0	0	1	0	1
17894	0	0	1	0	1
17900	0	0	0	1	1
17902	0	0	0	1	1
17909	0	0	1	0	1
17933	0	0	1	0	1
17935	0	0	0	1	1
17936	0	0	1	0	1
17939	0	1	0	0	1
17945	0	0	0	1	1
17947	0	0	1	0	1
17951	0	1	0	0	1
17953	0	1	0	0	1
17966	0	0	0	1	1
17971	0	0	0	1	1
17975	0	0	1	0	1
17977	0	0	1	0	1
17979	0	0	0	1	1
17980	0	0	1	1	2
17982	0	0	1	0	1
17990	0	1	0	0	1
17994	0	0	1	0	1
17995	0	1	0	0	1
18011	0	0	1	0	1
18012	0	0	0	1	1
18022	0	0	1	0	1
18025	0	0	2	0	2
18035	0	1	0	0	1
18039	0	0	1	0	1
18049	0	1	1	0	2
18051	0	1	0	0	1
18052	0	0	0	1	1
18055	0	0	0	1	1
18056	0	0	1	0	1
18057	0	0	1	0	1
18058	0	1	0	0	1
18060	0	1	0	1	2
18062	0	0	0	1	1
18065	0	1	1	0	2
18066	0	1	0	0	1
18069	0	0	1	0	1
18075	0	0	0	1	1
18085	0	1	0	0	1
18088	0	0	1	0	1
18089	0	1	0	0	1
18093	0	0	1	0	1
18096	0	0	1	0	1
18099	0	1	1	0	2
18100	0	1	0	0	1
18103	0	0	0	1	1
18107	0	0	0	1	1
18110	0	1	1	0	2
18126	0	0	1	0	1
18130	0	0	1	0	1
18135	0	1	0	0	1
18136	0	1	0	0	1
18138	0	0	0	2	2
18144	0	1	1	1	3
18145	0	1	0	0	1
18146	0	1	0	0	1
18148	0	0	0	1	1
18149	0	1	0	0	1
18150	0	0	1	0	1
18153	0	0	1	0	1
18162	0	0	1	0	1
18185	0	0	1	0	1
18187	0	1	0	0	1
18190	0	0	1	0	1
18194	0	0	1	1	2
18198	0	1	1	1	3
18203	0	0	0	2	2
18207	0	1	0	0	1
18208	0	0	1	0	1
18214	0	1	1	0	2
18215	0	0	1	0	1
18225	0	0	1	0	1
18227	0	0	1	0	1
18228	0	1	0	0	1
18237	0	1	0	0	1
18249	0	0	1	0	1
18252	0	0	1	0	1
18255	0	0	1	0	1
18256	0	0	1	0	1
18263	0	0	2	0	2
18271	0	1	0	0	1
18275	0	0	1	0	1
18276	0	1	0	0	1
18283	0	0	1	0	1
18291	0	0	0	1	1
18299	0	1	0	0	1
18303	0	1	0	0	1
18317	0	1	0	0	1
18326	0	1	0	0	1
18329	0	0	1	0	1
18339	0	1	0	0	1
18345	0	0	1	0	1
18346	0	1	0	0	1
18352	0	1	0	0	1
18353	0	0	1	0	1
18358	0	1	0	0	1
18360	0	0	1	0	1
18370	0	0	1	0	1
18381	0	1	1	0	2
18390	0	1	0	0	1
18392	0	1	0	0	1
18394	0	1	0	0	1
18398	0	0	1	0	1
18407	0	1	0	0	1
18414	0	0	1	0	1
18418	0	1	0	0	1
18419	0	0	1	0	1
18425	0	1	0	0	1
18428	0	1	0	0	1
18435	0	1	0	0	1
18439	0	2	0	0	2
18456	0	0	1	0	1
18461	0	1	0	0	1
18468	0	1	0	0	1
18473	0	1	0	0	1
18476	0	0	2	0	2
18482	0	0	1	0	1
18491	0	0	1	0	1
18519	0	0	0	1	1
18535	0	1	0	0	1
18540	0	0	1	0	1
18543	0	0	1	0	1
18544	0	1	0	0	1
18552	0	1	0	0	1
18559	0	1	0	0	1
18566	0	0	1	0	1
18568	0	1	0	0	1
18573	0	0	0	1	1
18577	0	0	1	0	1
18587	0	0	0	1	1
18595	0	0	0	1	1
18597	0	0	0	1	1
18598	0	1	0	0	1
18606	0	0	1	0	1
18612	0	1	0	0	1
18622	0	0	1	0	1
18626	0	1	0	0	1
18632	0	0	1	0	1
18641	0	1	0	0	1
18642	0	0	1	0	1
18647	0	0	1	0	1
18649	0	1	0	0	1
18650	0	0	1	0	1
18657	0	0	0	1	1
18662	0	0	1	0	1
18667	0	0	1	0	1
18669	0	0	0	1	1
18683	0	0	1	0	1
18694	0	0	0	1	1
18699	0	0	1	0	1
18708	0	1	0	0	1
18710	0	0	1	0	1
18721	0	0	1	0	1
18738	0	2	0	1	3
18743	0	0	1	0	1
18744	0	1	0	0	1
18752	0	0	1	0	1
18761	0	0	0	1	1
18765	0	1	0	0	1
18773	0	0	1	0	1
18776	0	0	0	1	1
18780	0	0	0	1	1
18785	0	0	1	0	1
18786	0	1	0	0	1
18791	0	0	1	0	1
18799	0	1	1	0	2
18803	0	1	0	0	1
18822	0	1	0	0	1
18824	0	1	0	0	1
18825	0	0	0	1	1
18827	0	1	0	0	1
18837	0	1	0	0	1
18840	0	1	1	0	2
18847	0	0	2	0	2
18848	0	1	1	0	2
18853	0	0	1	0	1
18857	0	0	1	0	1
18861	0	1	0	0	1
18871	0	0	1	0	1
18886	0	0	0	1	1
18895	0	1	0	0	1
18905	0	0	1	0	1
18906	0	1	0	0	1
18907	0	0	1	0	1
18920	0	0	1	0	1
18933	0	0	0	1	1
18937	0	0	1	0	1
18948	0	2	0	0	2
18950	0	1	0	0	1
18967	0	1	0	0	1
18973	0	0	1	0	1
18974	0	0	1	0	1
18980	0	0	1	0	1
18981	0	1	0	0	1
18999	0	0	1	0	1
19001	0	0	1	0	1
19016	0	0	1	1	2
19019	0	0	0	1	1
19040	0	1	0	0	1
19047	0	0	0	1	1
19054	0	0	1	0	1
19055	0	1	0	0	1
19056	0	0	1	0	1
19057	0	0	0	1	1
19084	0	1	0	0	1
19085	0	0	1	0	1
19109	0	1	0	0	1
19110	0	0	1	0	1
19111	0	0	1	0	1
19115	0	0	1	0	1
19126	0	1	0	0	1
19145	0	0	1	0	1
19149	0	0	2	0	2
19150	0	0	1	0	1
19152	0	0	1	0	1
19155	0	1	0	0	1
19159	0	0	1	0	1
19168	0	1	0	0	1
19176	0	0	1	0	1
19187	0	1	0	0	1
19193	0	1	0	0	1
19199	0	1	0	0	1
19202	0	0	1	0	1
19205	0	1	0	1	2
19207	0	0	1	0	1
19211	0	1	0	0	1
19227	0	1	0	0	1
19228	0	1	0	0	1
19232	0	0	1	0	1
19260	0	0	1	0	1
19269	0	0	1	0	1
19272	0	1	0	0	1
19274	0	0	1	0	1
19285	0	0	0	1	1
19298	0	1	0	0	1
19322	0	1	0	0	1
19331	0	0	1	0	1
19342	0	0	1	0	1
19349	0	1	1	0	2
19351	0	0	1	0	1
19354	0	1	0	0	1
19366	0	1	0	0	1
19370	0	0	1	0	1
19371	0	1	0	0	1
19384	0	1	0	0	1
19407	0	0	1	0	1
19411	0	0	0	1	1
19418	0	0	0	1	1
19425	0	0	0	1	1
19429	0	0	1	0	1
19435	0	0	1	0	1
19484	0	0	0	1	1
19499	0	0	1	0	1
19501	0	1	0	0	1
19505	0	1	0	0	1
19509	0	1	1	0	2
19510	0	1	0	0	1
19520	0	1	0	0	1
19523	0	1	0	1	2
19525	0	2	0	0	2
19530	0	0	1	0	1
19539	0	1	0	0	1
19545	0	1	0	0	1
19547	0	0	1	0	1
19552	0	0	1	0	1
19553	0	0	1	0	1
19562	0	0	1	0	1
19569	0	1	0	0	1
19570	0	1	1	0	2
19575	0	1	0	0	1
19585	0	1	0	0	1
19589	0	1	0	0	1
19593	0	0	0	1	1
19596	0	0	1	0	1
19620	0	0	0	1	1
19623	0	0	0	1	1
19628	0	0	0	1	1
19631	0	1	0	0	1
19644	0	0	1	0	1
19645	0	1	0	0	1
19660	0	1	0	0	1
19701	0	0	1	0	1
19703	0	0	1	0	1
19704	0	0	1	0	1
19709	0	0	1	0	1
19710	0	0	1	0	1
19724	0	1	0	0	1
19733	0	1	0	0	1
19736	0	0	1	0	1
19746	0	0	1	0	1
19759	0	1	0	0	1
19763	0	0	0	1	1
19772	0	1	0	0	1
19776	0	0	1	0	1
19778	0	2	0	0	2
19780	0	1	0	0	1
19781	0	1	0	0	1
19803	0	0	1	0	1
19806	0	0	1	0	1
19810	0	0	1	0	1
19811	0	0	1	0	1
19823	0	1	0	0	1
19825	0	0	1	0	1
19841	0	0	1	0	1
19852	0	0	0	1	1
19863	0	0	1	0	1
19872	0	0	1	0	1
19880	0	0	1	0	1
19885	0	0	1	0	1
19895	0	1	0	0	1
19901	0	1	0	0	1
19905	0	1	0	0	1
19907	0	0	1	0	1
19911	0	1	0	0	1
19915	0	0	1	0	1
19923	0	1	0	0	1
19925	0	0	1	0	1
19952	0	2	0	0	2
19957	0	1	0	0	1
19961	0	0	1	0	1
19997	0	0	1	0	1
20008	0	0	1	0	1
20013	0	0	1	0	1
20015	0	1	0	0	1
20022	0	1	0	0	1
20047	0	1	0	0	1
20050	0	0	1	0	1
20057	0	0	1	0	1
20067	0	0	0	1	1
20094	0	1	0	0	1
20095	0	0	1	0	1
20104	0	0	1	0	1
20113	0	1	0	0	1
20122	0	0	1	0	1
20126	0	0	1	0	1
20132	0	0	1	1	2
20135	0	0	1	0	1
20144	0	0	0	1	1
20165	0	0	1	0	1
20190	0	0	1	0	1
20192	0	1	0	0	1
20193	0	1	0	0	1
20198	0	0	1	0	1
20202	0	0	1	0	1
20208	0	0	1	0	1
20210	0	1	0	0	1
20230	0	1	0	0	1
20238	0	0	0	1	1
20257	0	0	1	0	1
20265	0	0	0	1	1
20272	0	1	0	0	1
20293	0	1	0	0	1
20294	0	0	1	0	1
20304	0	0	0	1	1
20309	0	1	0	0	1
20319	0	0	1	0	1
20337	0	0	1	0	1
20342	0	0	1	0	1
20353	0	0	1	0	1
20377	0	0	1	0	1
20397	0	1	0	0	1
20402	0	0	0	1	1
20407	0	0	1	0	1
20412	0	1	0	0	1
20423	0	1	0	0	1
20425	0	0	0	1	1
20454	0	1	0	0	1
20486	0	0	1	0	1
20495	0	0	1	0	1
20499	0	1	0	0	1
20537	0	1	0	0	1
20552	0	0	2	0	2
20563	0	0	1	0	1
20565	0	0	1	0	1
20573	0	0	1	0	1
20578	0	1	0	0	1
20594	0	0	1	0	1
20605	0	0	1	0	1
20610	0	0	1	0	1
20619	0	0	0	1	1
20625	0	1	0	0	1
20632	0	0	1	1	2
20683	0	0	0	1	1
20692	0	0	1	0	1
20712	0	1	0	0	1
20717	0	0	1	0	1
20773	0	0	1	0	1
20781	0	1	0	0	1
20783	0	0	1	0	1
20799	0	0	1	0	1
20800	0	0	1	0	1
20811	0	0	1	0	1
20813	0	0	1	0	1
20826	0	0	1	0	1
20838	0	1	0	0	1
20844	0	0	0	1	1
20847	0	0	1	0	1
20850	0	1	0	0	1
20868	0	0	1	0	1
20875	0	0	0	1	1
20883	0	1	0	0	1
20892	0	1	0	0	1
20930	0	0	1	0	1
20937	0	0	0	1	1
20950	0	0	1	0	1
20998	0	0	1	0	1
21008	0	0	1	0	1
21011	0	0	0	1	1
21066	0	0	1	0	1
21084	0	1	0	0	1
21092	0	1	0	0	1
21112	0	1	0	0	1
21120	0	1	0	0	1
21179	0	0	1	0	1
21211	0	1	0	0	1
21215	0	0	1	0	1
21216	0	1	0	0	1
21244	0	0	0	1	1
21266	0	0	1	0	1
21271	0	0	1	0	1
21279	0	1	0	0	1
21291	0	0	0	1	1
21292	0	0	1	0	1
21304	0	0	0	1	1
21326	0	0	1	0	1
21330	0	0	1	0	1
21348	0	1	0	0	1
21351	0	1	0	0	1
21364	0	1	0	0	1
21389	0	0	1	0	1
21430	0	0	1	0	1
21437	0	0	0	1	1
21438	0	0	1	0	1
21440	0	1	0	0	1
21449	0	0	0	1	1
21480	0	1	0	0	1
21488	0	0	0	1	1
21511	0	0	1	0	1
21524	0	0	1	0	1
21531	0	0	0	1	1
21540	0	0	1	0	1
21555	0	1	0	0	1
21562	0	1	0	0	1
21568	0	1	0	0	1
21570	0	1	0	0	1
21579	0	1	0	0	1
21598	0	1	0	0	1
21604	0	1	0	0	1
21615	0	0	1	0	1
21616	0	0	1	0	1
21621	0	0	1	0	1
21627	0	1	0	0	1
21634	0	0	1	0	1
21639	0	0	1	0	1
21658	0	0	1	0	1
21671	0	0	1	0	1
21672	0	0	1	0	1
21676	0	1	0	0	1
21677	0	1	0	0	1
21722	0	1	0	0	1
21725	0	1	0	0	1
21734	0	1	0	0	1
21775	0	1	0	0	1
21776	0	0	1	0	1
21782	0	1	0	0	1
21800	0	1	0	0	1
21814	0	0	1	0	1
21823	0	1	0	0	1
21878	0	1	0	0	1
21926	0	0	1	0	1
21929	0	0	1	0	1
21967	0	0	1	0	1
21985	0	1	0	0	1
21990	0	1	1	0	2
22041	0	0	0	1	1
22053	0	0	1	0	1
22105	0	0	1	0	1
22109	0	1	0	0	1
22145	0	1	0	0	1
22195	0	0	1	0	1
22196	0	0	1	0	1
22256	0	0	0	1	1
22260	0	1	0	0	1
22280	0	1	0	0	1
22295	0	1	0	0	1
22380	0	1	0	0	1
22384	0	0	0	1	1
22453	0	0	1	0	1
22470	0	1	0	0	1
22500	0	0	1	0	1
22598	0	0	1	0	1
22599	0	0	1	0	1
22634	0	0	0	1	1
22637	0	1	0	0	1
22670	0	0	2	0	2
22705	0	0	0	1	1
22765	0	0	1	0	1
22847	0	0	1	0	1
22854	0	1	0	0	1
22866	0	0	1	0	1
22879	0	1	0	0	1
22895	0	0	1	0	1
22898	0	1	0	0	1
22932	0	0	0	1	1
22940	0	1	0	0	1
22953	0	0	0	1	1
22969	0	0	1	0	1
22989	0	0	1	0	1
23000	0	1	0	0	1
23002	0	0	1	0	1
23008	0	1	0	0	1
23031	0	0	1	0	1
23041	0	0	1	0	1
23084	0	0	1	0	1
23104	0	1	1	0	2
23169	0	0	1	0	1
23193	0	0	0	1	1
23235	0	0	1	0	1
23249	0	1	0	0	1
23340	0	1	0	0	1
23343	0	0	1	0	1
23352	0	0	1	0	1
23363	0	1	0	0	1
23367	0	1	0	0	1
23399	0	0	1	0	1
23441	0	0	1	0	1
23483	0	0	1	0	1
23486	0	0	1	0	1
23550	0	1	0	0	1
23554	0	0	1	0	1
23587	0	0	0	1	1
23589	0	0	0	1	1
23608	0	0	1	0	1
23690	0	1	0	0	1
23714	0	0	1	0	1
23731	0	0	1	0	1
23743	0	1	0	0	1
23760	0	1	0	0	1
23848	0	0	1	0	1
23866	0	0	1	0	1
23878	0	0	1	0	1
23930	0	1	0	0	1
24003	0	0	1	0	1
24011	0	0	1	0	1
24018	0	1	0	0	1
24061	0	1	0	0	1
24088	0	1	0	0	1
24116	0	0	0	1	1
24127	0	0	0	1	1
24195	0	0	0	1	1
24255	0	0	1	0	1
24264	0	1	0	0	1
24307	0	1	0	0	1
24343	0	1	0	0	1
24353	0	0	1	0	1
24523	0	1	0	0	1
24615	0	0	0	1	1
24636	0	1	0	0	1
24676	0	1	0	0	1
24714	0	0	0	1	1
24737	0	0	1	0	1
24916	0	0	0	1	1
24966	0	0	1	0	1
25013	0	1	0	0	1
25088	0	0	1	0	1
25217	0	1	0	0	1
25240	0	0	1	0	1
25246	0	0	1	0	1
25305	0	0	1	0	1
25369	0	0	1	0	1
25374	0	1	0	0	1
25476	0	0	1	0	1
25514	0	0	1	0	1
25530	0	0	0	1	1
25563	0	0	1	0	1
25604	0	0	1	0	1
25716	0	0	0	1	1
25778	0	0	0	1	1
25890	0	0	1	0	1
26012	0	0	1	0	1
26221	0	0	1	0	1
26273	0	1	0	0	1
26375	0	0	1	0	1
26494	0	0	1	0	1
26529	0	0	1	0	1
26625	0	0	1	0	1
26665	0	0	0	1	1
26735	0	0	1	0	1
27157	0	0	1	0	1
27214	0	1	0	0	1
27221	0	0	1	0	1
27263	0	0	1	0	1
27466	0	1	0	0	1
27469	0	0	1	0	1
27555	0	1	0	0	1
27849	0	0	0	1	1
27860	0	0	1	0	1
27896	0	1	0	0	1
28000	0	0	1	0	1
28040	0	1	0	0	1
28198	0	1	0	0	1
28316	0	1	0	0	1
28345	0	1	0	0	1
28898	0	0	1	0	1
29701	0	0	1	0	1
30035	0	0	1	0	1
30129	0	0	0	1	1
30591	0	1	0	0	1
30601	0	0	0	1	1
30615	0	0	0	1	1
30812	0	0	1	0	1
31267	0	0	1	0	1
31669	0	0	1	0	1
31745	0	0	0	1	1
33210	0	1	0	0	1
33995	0	1	0	0	1
34557	0	0	0	1	1
35169	0	0	1	0	1
35702	0	1	0	0	1
35973	0	0	1	0	1
37327	0	0	0	1	1
37329	0	1	0	0	1
37769	0	1	0	0	1
43949	0	0	1	0	1
44069	0	0	1	0	1
50130	0	0	0	1	1
50133	0	0	2	0	2
50156	0	0	0	1	1
50200	0	0	1	0	1
50219	0	0	1	0	1
50225	0	1	0	0	1
50272	0	0	1	0	1
50302	0	1	0	0	1
50307	0	1	0	0	1
50328	0	0	1	0	1
50350	0	0	1	0	1
50353	0	0	1	0	1
50374	0	1	0	0	1
50415	0	0	1	0	1
50417	0	1	0	0	1
50431	0	1	0	0	1
50435	0	0	1	0	1
50472	0	0	1	0	1
50495	0	1	0	0	1
50558	0	0	0	1	1
50621	0	0	1	0	1
50638	0	0	1	0	1
50712	0	0	1	0	1
50719	0	0	1	0	1
50720	0	1	0	0	1
50741	0	1	0	0	1
50748	0	0	0	1	1
50766	0	1	0	0	1
50769	0	2	0	0	2
50787	0	1	0	0	1
50796	0	1	0	0	1
50811	0	0	2	0	2
50833	0	0	1	0	1
50843	0	1	0	0	1
50871	0	0	0	1	1
50874	0	0	1	0	1
50898	0	1	0	0	1
50946	0	0	1	0	1
50948	0	1	0	0	1
50964	0	0	1	0	1
51023	0	1	0	0	1
51027	0	1	0	0	1
51062	0	1	0	0	1
51099	0	0	1	0	1
51141	0	0	1	0	1
51142	0	0	1	0	1
51152	0	1	0	0	1
51298	0	0	0	1	1
51303	0	0	1	1	2
51331	0	0	2	0	2
51421	0	0	1	0	1
51441	0	1	0	0	1
51483	0	0	0	1	1
51504	0	0	1	0	1
51531	0	1	0	0	1
51540	0	0	1	0	1
51551	0	0	0	1	1
51571	0	0	1	0	1
51572	0	0	0	1	1
51662	0	1	0	0	1
51702	0	0	0	1	1
51729	0	0	1	0	1
51775	0	1	0	0	1
51780	0	0	2	0	2
51808	0	1	0	0	1
51821	0	0	1	0	1
51827	0	0	1	0	1
51851	0	1	0	0	1
51903	0	0	0	1	1
51938	0	0	1	0	1
51948	0	0	1	0	1
52000	0	0	1	0	1
52019	0	0	1	0	1
52033	0	0	1	0	1
52040	0	0	1	0	1
52053	0	0	1	0	1
52158	0	1	0	0	1
52190	0	0	0	1	1
52207	0	2	0	0	2
52254	0	0	1	0	1
52268	0	1	0	0	1
52280	0	1	0	0	1
52308	0	1	0	0	1
52312	0	0	1	0	1
52314	0	0	1	0	1
52322	0	1	0	0	1
52353	0	0	1	0	1
52457	0	1	0	0	1
52460	0	1	0	0	1
52503	0	0	1	0	1
52618	0	0	1	0	1
52629	0	1	0	0	1
52639	0	1	0	0	1
52653	0	0	0	1	1
52806	0	0	1	0	1
52824	0	0	1	0	1
52856	0	0	1	0	1
52893	0	0	1	0	1
52907	0	0	1	0	1
52946	0	0	0	1	1
52990	0	0	1	0	1
53064	0	0	1	0	1
53146	0	0	1	0	1
53257	0	0	1	0	1
53288	0	0	1	0	1
53444	0	1	0	0	1
53454	0	0	1	0	1
53625	0	0	1	0	1
53901	0	0	0	1	1
53913	0	0	0	1	1
53971	0	0	0	1	1
54090	0	0	0	1	1
54121	0	1	0	0	1
54122	0	1	0	0	1
54172	0	0	1	0	1
54344	0	0	1	0	1
54493	0	0	1	0	1
54511	0	0	0	1	1
54537	0	1	0	0	1
54702	0	0	1	0	1
54769	0	0	1	0	1
54773	0	0	1	0	1
54783	0	0	1	0	1
54848	0	1	0	0	1
55141	0	0	1	0	1
55277	0	0	1	0	1
55379	0	1	0	0	1
55572	0	0	1	0	1
55640	0	1	0	0	1
56149	0	1	0	0	1
56402	0	1	0	0	1
56733	0	1	0	0	1
56865	0	0	1	0	1
57015	0	1	0	0	1
57018	0	1	0	0	1
57092	0	0	0	1	1
57133	0	0	1	0	1
57401	0	1	0	0	1
57794	0	0	1	0	1
58078	0	0	1	0	1
58853	0	0	0	1	1
60138	1	0	0	0	1
60143	1	0	0	0	1
60200	1	0	0	0	1
60206	1	0	0	0	1
60215	0	0	1	0	1
60271	1	0	0	0	1
60278	1	0	0	0	1
60330	1	0	0	0	1
60382	1	0	0	0	1
60599	0	1	0	0	1
60806	1	0	0	0	1
60942	1	0	0	0	1
61164	1	0	0	0	1
61352	1	0	0	0	1
61626	0	0	0	1	1
62022	1	0	0	0	1
62118	1	0	0	0	1
62934	1	0	0	0	1
62961	1	0	0	0	1
63130	1	0	0	0	1
63591	0	1	0	0	1
63848	1	0	0	0	1
63937	1	0	0	0	1
64067	0	0	0	1	1
64592	1	0	0	0	1
74233	0	0	1	0	1
100114	0	0	1	0	1
100130	0	1	0	0	1
100196	0	1	0	0	1
100228	0	0	0	1	1
100263	0	0	1	0	1
100267	0	1	0	0	1
100310	0	0	1	0	1
100394	0	0	1	0	1
100434	0	0	1	0	1
100638	0	1	0	0	1
100786	0	0	1	0	1
101036	0	1	0	0	1
101483	0	0	0	1	1
101523	0	1	0	0	1
101629	0	1	0	0	1
102086	0	0	0	1	1
102237	0	0	1	0	1
102386	0	0	1	0	1
102409	0	1	0	0	1
103012	0	0	1	0	1
103053	0	0	1	0	1
103069	0	1	0	0	1
103556	0	0	0	1	1
104004	0	0	0	1	1
104144	0	1	0	0	1
104992	0	0	0	1	1
105157	0	0	1	0	1
106021	0	0	1	0	1
106380	0	0	0	1	1
106490	0	0	0	1	1
110772	1	0	0	0	1
142355	0	0	1	0	1
150223	0	0	0	1	1
150389	0	0	1	0	1
150526	0	0	1	0	1
150612	0	1	0	0	1
150696	0	1	0	0	1
151125	0	0	1	0	1
151334	0	0	1	0	1
151576	0	0	1	0	1
151580	0	1	0	0	1
151725	0	1	0	0	1
151888	0	0	1	0	1
152005	0	0	1	0	1
152622	0	1	0	0	1
152706	0	0	1	0	1
152724	0	0	1	0	1
153227	0	0	1	0	1
153322	0	0	1	0	1
153521	0	1	0	0	1
154476	0	1	0	0	1
154782	0	1	0	0	1
156714	0	0	1	0	1
157290	0	1	0	0	1
159411	0	1	0	0	1
160056	0	0	1	0	1
163481	0	0	1	0	1
174244	0	0	1	0	1
181807	0	0	0	1	1
209807	0	1	0	0	1
316604	0	0	1	0	1
494167	0	1	0	0	1
1056921	0	0	1	0	1
3000360	0	0	0	1	1
3000665	0	0	0	1	1
3001103	0	0	1	0	1
3001284	0	0	0	1	1
3001287	0	0	1	0	1
3001975	0	0	0	1	1
3002900	0	0	0	1	1
3003574	0	1	0	0	1
3006384	0	0	0	1	1
3100263	0	0	0	1	1
3100902	0	0	0	1	1
3101226	0	0	0	1	1
3101333	0	0	0	1	1
3102047	0	0	0	1	1
3103349	0	0	0	1	1
3152944	0	0	0	1	1
3205185	0	1	0	0	1
9411551	1	0	0	0	1
11102078	0	1	0	0	1
16050212	1	0	0	0	1
18152556	0	1	0	0	1
19000061	1	0	0	0	1
19020631	1	0	0	0	1
20001075	1	0	0	0	1
21057674	0	0	1	0	1
30045531	0	0	0	1	1
